a	aA
abi	a b' I
aborigenams	a b o r' i g' E n a m s
aborigenų	a b o r' i g' E n uu
abu	a b U
adaptavosi	a d a p t aA v oo s' i
administraciniai	a d' m' i n' i s t r aA ts' i n' e j
afrikoj	aA f' r' i k oo j
afrikoje	aA f' r' i k oo j' e
afrikos	aA f' r' i k oo s
agresiją	a g' r' E s' i j' ea
aikštę	Aa j k' S' t' ea
airijoje	A J r' i j' oo j' e
aiškaus	a j S k A W s
aiškiai	Aa j S' k' e j
aiškindavęs	Aa j S' k' i n d a v' ea s
aišku	Aa j S k u
akcentais	a k' ts' E N t a j s
akcentas	a k' ts' E N t a s
akelių	a k' eA l' uu
akimi	a k' i m' I
akivaizdoje	a k' I v a j z d oo j' e
akmenimis	a k' m' e n' i m' I s
akmeniniais	a k' m' e n' I n' e j s
akmeninius	a k' m' e n' i n' U s
akmeninių	a k' m' e n' I n' uu
akmeninėmis	a k' m' e n' I n' ee m' i s
akmeniu	aA k' m' e n' u
akmens	a k' m' E N s
akmenys	aA k' m' e n' ii s
akmenėliai	a k' m' e n' eE l' e j
akmenų	a k' m' e n uU
akrobatai	a k r o b aA t a j
aktyviausi	a k' t' ii v' Ea w s' i
aktyviausia	a k' t' ii v' Ea w s' e
aktyvioje	a k' t' ii v' oo j' E
akys	aA k' ii s
aleksandriją	a l' e k s Aa n' d' r' i j' ea
aliaskoje	a l' eA s k oo j' e
alksnių	A L' k' s' n' uu
amatininkų	a m a t' i n' I N k uu
amato	aA m a t oo
amerikos	a m' E r' i k oo s
amžiais	Aa m' Z' e j s
amžiaus	Aa m' Z' e w s
amžiuje	Aa m' Z' u j' e
amžius	Aa m' Z' u s
anarchija	a n Aa r' x' i j' e
anga	a n g A
angelas	Aa n' g' e l a s
anglijoje	Aa n' g' l' i j' oo j' e
anglijos	Aa n' g' l' i j' oo s
angliškos	Aa n' g' l' i S k oo s
anglų	Aa n g l uu
angos	a n g oO s
angų	a n g uU
ankstesniųjų	a n' k' s' t' e s' n' uU j' uu
ankstesnį	a n' k' s' t' E s' n' ii
anksčiau	a n' k' S' tS' E W
ansambliuose	a n s Aa m' b' l' uo s' e
ansamblių	a n s Aa m' b' l' uu
ant	a n t
antano	a n t aA n oo
antarktidoje	a n t a r' k' t' I d oo j' e
antra	a n t r a
antrasis	a n t r A s' i s
antroje	a n t r oo j' E
antrojoje	a n t r oO j' oo j' e
antropologas	a n t r o p o l O g a s
antrųjų	a n t r uU j' uu
anuomet	a n uO m' e t
apatinių	a p a t' I n' uu
apaugusius	a p Aa w g u s' u s
apaugęs	a p Aa w g' ea s
apeigas	aA p' e j g a s
apeiginės	a p' e j g' I n' ee s
apeigų	a p' e j g uU
apeina	a p' E J n a
apgadintas	a b g a d' I n t a s
apgaulingas	a b g a w l' I n g a s
apgraužtų	a b g r Aa w S t uu
apgriauta	a b' g' r' e w t a
apgyvendintą	a b' g' ii v' Ea n' d' i n t aa
apibrėžta	a p' i b' r' ee S t a
apibūdinami	a p' i b uU d' i n a m' i
apibūdinimų	a p' i b uU d' i n' i m uu
apie	a p' ie
apimantis	A p' i m a n' t' i s
apimties	a p' i m' t' iE s
apipinti	a p' i p' I n' t' i
apjuostas	a p' j' uo s t a s
aplankyti	a p l a n' k' Ii t' i
apleidžiama	a p' l' e j dZ' e m a
aplink	a p' l' I N k
aplinkai	aA p' l' i n k a j
apnašas	aA p n a S a s
apnašus	aA p n a S u s
aprašydavo	a p r a S' Ii d a v oo
aprūpina	a p r Uu p' i n a
apsaugą	a p s a w g aa
apsiginti	a p' s' i g' i n' t' i
apsigyveno	a p' s' i g' ii v' eA n oo
apsireiškė	a p' s' i r' Ea j S' k' ee
apsivogdavo	a p' s' i v oO g d a v oo
apsuptas	A p s u p t a s
aptakus	a p t a k U s
aptašytų	a p t a S' Ii t uu
aptiko	a p' t' I k oo
aptikta	a p' t' i k t a
aptikti	a p' t' I k' t' i
aptikęs	a p' t' I k' ea s
aptinkama	a p' t' i n k a m a
apuokų	a p Uo k uu
apylinkėse	a p' Ii l' i n' k' ee s' e
apytikriai	a p' Ii t' i k' r' e j
ar	a r
arabijos	a r aA b' i j' oo s
arba	a r b a
archajiška	a r x aA j' i S k a
archajiškas	a r x aA j' i S k a s
archajiškos	a r x aA j' i S k oo s
archeologai	a r' x' e o l O g a j
archeologiniai	a r' x' e o l O g' i n' e j
archeologiniais	a r' x' e o l O g' i n' e j s
archeologinių	a r' x' e o l O g' i n' uu
architektūra	a r' x' i t' e k t uu r A
architektūriniais	a r' x' i t' e k t uU r' i n' e j s
architektūrinis	a r' x' i t' e k t uU r' i n' i s
architektūrinių	a r' x' i t' e k t uU r' i n' uu
architektūros	a r' x' i t' e k t uU r oo s
architektūrą	a r' x' i t' e k t uU r aa
ardo	A R d oo
arime	a r' i m' E
arkliai	a r' k' l' E J
arkliams	a r' k' l' Ea m s
arklių	a r' k' l' uU
arkties	Aa r' k' t' ie s
armija	Aa r' m' i j' e
armiją	Aa r' m' i j' ea
artikuliacija	a r' t' i k u l' eA ts' i j' e
asmenvardžiu	a s' m' Ea n v a r' dZ' u
asmenys	aA s' m' e n' ii s
asocijuojasi	a s o ts' i j' Uo j' e s' i
astronominiai	a s t r o n O m' i n' e j
atbaidyti	a d b a j d' Ii t' i
atgabenti	a d g a b' Ea n' t' i
atiduodamas	a t' i d Uo d a m a s
atiteko	a t' i t' eA k oo
atitempti	a t' i t' E M' p' t' i
atitinka	a t' i t' I N k a
atkarpos	a t k a r p oO s
atkasama	a t k a s a m a
atkasamos	A t k a s a m oo s
atkastų	a t k A s t uu
atkeliavo	a t' k' e l' eA v oo
atkurta	a t k u r t a
atkūrimo	a t k uu r' I m oo
atlaikytų	a t l a j k' Ii t uu
atlanto	a t l Aa n t oo
atleidžiami	a t' l' e j dZ' e m' I
atliekami	a t' l' ie k a m' I
atliekamos	a t' l' ie k a m oo s
atliekant	a t' l' iE k a n t
atlikdavo	a t' l' I g d a v oo
atliko	a t' l' I k oo
atliktas	A t' l' i k t a s
atmosferą	a t m o s' f' E r aa
atogrąžos	a t Oo g r aa Z oo s
atogrąžose	a t Oo g r aa Z oo s' e
atogrąžų	a t Oo g r aa Z uu
atpažinti	a t p a Z' I n' t' i
atpažįstamas	a t p a Z' Ii s t a m a s
atradimas	a t r a d' I m a s
atradimui	a t r a d' I m u j
atrastas	A t r a s t a s
atrastos	a t r a s t oo s
atrodo	a t r Oo d oo
atrodyti	a t r Oo d' ii t' i
atsakymų	a t s aA k' ii m uu
atsargas	aA t s a r g a s
atsiduriama	a t' s' i d u r' e m a
atsiduriame	a t' s' I d u r' e m' e
atsiradimo	a t' s' i r a d' I m oo
atsirado	a t' s' i r aA d oo
atsirasti	a t' s' i r A s' t' i
atsiskyrėliams	a t' s' i s' k' Ii r' ee l' e m s
atsispindi	a t' s' i s' p' I N' d' i
atsispindintys	a t' s' i s' p' I N' d' i n' t' ii s
atsitiktinai	a t' s' i t' i k' t' i n A J
atsitraukė	a t' s' i t r Aa w k' ee
atsivežti	a t' s' i v' E S' t' i
atsivežė	a t' s' I v' e Z' ee
atsižvelgdami	a t' s' i Z' v' e l g d a m' I
atskira	a t' s' k' i r a
atskiras	aA t' s' k' i r a s
atskiromis	a t' s' k' i r oo m' I s
atskiroms	a t' s' k' i r Oo m s
atskirti	a t' s' k' I r' t' i
atskirų	a t' s' k' i r uU
atsparūs	a t s p aA r uu s
atspindintys	a t' s' p' I N' d' i n' t' ii s
atspindėjo	a t' s' p' i n' d' Ee j' oo
atstatydavo	a t s t a t' Ii d a v oo
atstatymo	a t s t aA t' ii m oo
atstoja	a t s t Oo j' e
atstovai	a t s t oO v a j
atstovauja	a t s t oo v Aa w j' e
atstovų	a t s t oO v uu
atstumais	a t s t U m a j s
atstumams	a t s t U m a m s
atstumus	a t s t u m U s
atstumą	a t s t U m aa
atvaizdai	a t v a j z d A J
atvaizdais	a t v a j z d A J s
atveju	aA t' v' e j' u
atversti	a t' v' E R' s' t' i
atverti	a t' v' e r' t' i
atvežti	a t' v' E S' t' i
atvykus	a t' v' iI k u s
atvykę	a t' v' iI k' ea
atšiauri	a t' S' e w r' I
atšilimu	a t' S' i l' i m U
atžvilgiu	aA d' Z' v' i l' g' u
audiniais	a w d' i n' E J s
audinės	a w d' i n' ee s
audringiausiu	a w d' r' i n' g' Ea w s' u
audrų	a w d r uU
auga	Aa w g a
augalai	a w g a l A J
augalais	a w g a l A J s
augaliją	a w g a l' I j' ea
augalų	a w g a l uU
augančių	Aa w g a n' tS' uu
augindami	a w g' I n d a m' i
augmenijos	a w g' m' e n' I j' oo s
auklėtinis	Aa w k' l' ee t' i n' i s
auksinėmis	a w k' s' i n' ee m' i s
aukso	Aa w k s oo
aukšta	a w k S t a
aukštai	a w k S t A J
aukštaitijos	a w k S t a j t' I j' oo s
aukštaičiai	a w k S t A J tS' e j
aukštaičių	a w k S t A J tS' uu
aukštapelkių	a w k S t aA p' e l' k' uu
aukštas	a w k S t a s
aukštesnis	a w k' S' t' E s' n' i s
aukštis	A W k' S' t' i s
aukšto	a w k S t oo
aukštos	a w k S t oo s
aukštumo	a w k S t u m oo
aukštus	a w k S t u s
aukštutinės	a w k S t u t' I n' ee s
aukštyje	A W k' S' t' ii j' e
aukštyn	a w k' S' t' iI n
aukštys	a w k' S' t' ii s
aukštį	A W k' S' t' ii
aukščiau	a w k' S' tS' E W
aukščiausiais	a w k' S' tS' Ea w s' e j s
aukščiausio	a w k' S' tS' Ea w s' oo
aukščiausios	a w k' S' tS' Ea w s' oo s
aukščiausiąją	a w k' S' tS' Ea w s' ea j' ea
aukščio	A W k' S' tS' oo
australijos	a w s t r aA l' i j' oo s
austrų	Aa w s t r uu
ausų	a w s uU
autentiška	a w t' E N' t' i S k a
automobilių	a w t o m o b' I l' uu
autorystę	a w t oo r' iI s' t' ea
auš	A W S
auštant	A W S t a n t
azijoje	aA z' i j' oo j' e
azijos	aA z' i j' oo s
aš	A S
aštriai	a S' t' r' E J
aštriais	a S' t' r' E J s
aštuoni	a S t uo n' I
aštuoniasdešimt	a S t Uo n' e z' d' e S' i m t
aštuoniolikto	a S t uo n' Oo l' i k t oo
aštuonios	a S t Uo n' oo s
aštuonis	a S t Uo n' i s
aštuonių	a S t uo n' uU
badauti	b a d Aa w t' i
baigia	b A J g' e
baigiant	b A J g' e n t
baigimo	b a j g' I m oo
baigti	b A J k' t' i
baikalas	b a j k aA l a s
baikalo	b a j k aA l oo
baikalą	b a j k aA l aa
baikšti	b a j k' S' t' I
balsai	b a l s A J
balsas	b A L s a s
balso	b A L s oo
balsų	b a l s uU
baltai	b a l t a j
baltarusiai	b a l t a r U s' e j
baltarusijai	b a l t a r U s' i j' e j
baltarusiją	b a l t a r U s' i j' ea
baltasis	b a l t A s' i s
baltieji	b a l' t' Ie j' i
baltojo	b Aa l t oo j' oo
baltymų	b a l' t' ii m uU
baltąjį	b Aa l t aa j' ii
baltųjų	b a l t uU j' uu
bando	b A N d oo
bandomis	b a n d oo m' I s
banga	b a n g A
bangas	b a n g A s
banginis	b a n' g' I n' i s
banginių	b a n' g' I n' uu
bangomis	b a n g oo m' I s
banguojančios	b a n g Uo j' e n' tS' oo s
baseine	b a s' e j n' E
bažnytinio	b a Z' n' Ii t' i n' oo
bažnyčia	b a Z' n' Ii tS' e
bažnyčiai	b a Z' n' Ii tS' e j
bažnyčios	b a Z' n' Ii tS' oo s
be	b' e
bebrai	b' eA b r a j
bebras	b' eA b r a s
bebro	b' eA b r oo
bebrus	b' e b r U s
bebrų	b' eA b r uu
bei	b' e j
bendras	b' E N d r a s
bendrauti	b' e n d r Aa w t' i
bendravimo	b' e n d r aA v' i m oo
bendri	b' e n' d' r' I
bendrinė	b' e n' d' r' I n' ee
bendro	b' E N d r oo
bendruomeniniai	b' e n d r uo m' e n' I n' e j
bendruomenių	b' e n d r Uo m' e n' uu
bendruomenėje	b' e n d r Uo m' e n' ee j' e
bendruomenės	b' e n d r Uo m' e n' ee s
bene	b' e n' E
bent	b' e n t
bernelio	b' e r' n' eA l' oo
besikartojančiais	b' e s' i k a r t Oo j' e n' tS' e j s
besikeičiantis	b' e s' i k' E J tS' e n' t' i s
besikeičiančios	b' e s' i k' E J tS' e n' tS' oo s
besikeičiančiu	b' e s' i k' E J tS' e n' tS' u
besikuriančios	b' e s' I k u r' e n' tS' oo s
besniegių	b' e s' n' iE g' uu
bet	b' e t
beveik	b' e v' Ea j k
beždžionė	b' e Z' dZ' oO n' ee
bibliotekai	b' i b' l' i o t' E k a j
biologas	b' i o l O g a s
bizantinio	b' i z Aa n' t' i n' oo
bizantinėmis	b' i z Aa n' t' i n' ee m' i s
blokai	b l O k a j
blokas	b l O k a s
blokus	b l o k U s
blokų	b l O k uu
bokštai	b Oo k S t a j
bokštas	b Oo k S t a s
bokštu	b Oo k S t u
bokštą	b Oo k S t aa
bokštų	b Oo k S t uu
brakonieriai	b r a k o n' iE r' e j
brangakmenius	b r Aa n g a k' m' e n' u s
briedžio	b' r' Ie dZ' oo
britų	b' r' I t uu
bruožai	b r Uo Z a j
bruožas	b r Uo Z a s
bu	b U
budistų	b u d' I s t uu
buitis	b u j t' I s
bulgarų	b u l g aA r uu
burtažodžiai	b u r t aA Z oo dZ' e j
bus	b U s
buveinė	b u v' E J n' ee
buvo	b U v oo
buvusi	b U v u s' i
buvusius	b U v u s' u s
buvusią	b U v u s' ea
byloja	b' ii l Oo j' e
bėgantis	b' Ee g a n' t' i s
bū	b uU
būdamas	b Uu d a m a s
būdas	b uU d a s
būdavo	b Uu d a v oo
būdinga	b uu d' I n g a
būdingas	b uu d' I n g a s
būdingi	b uu d' I n' g' i
būdingą	b uu d' I n g aa
būdu	b uu d U
būklė	b Uu k' l' ee
būklę	b Uu k' l' ea
būna	b uU n a
būriai	b uu r' E J
būstuose	b Uu s t uo s' e
būta	b uu t a
būti	b Uu t' i
būtybėms	b uu t' Ii b' ee m s
būtybės	b uu t' Ii b' ee s
būtų	b Uu t uu
carinė	ts a r' I n' ee
celių	ts' E l' uu
celėse	ts' E l' ee s' e
centimetro	ts' e n' t' i m' E t r oo
centimetrų	ts' e n' t' i m' E t r uu
centrai	ts' E N t r a j
centras	ts' E N t r a s
centriniam	ts' e n' t' r' i n' e m
centrinėje	ts' e n' t' r' I n' ee j' e
centrinę	ts' e n' t' r' I n' ea
centro	ts' E N t r oo
centru	ts' e n t r U
centrą	ts' E N t r aa
centrų	ts' E N t r uu
chameleonai	x a m' e l' e O n a j
chorai	x O r a j
choru	x o r U
chromosomos	x r o m o s O m oo s
chromosomų	x r o m o s O m uu
civilizacija	ts' i v' i l' i z aA ts' i j' e
civilizacijos	ts' i v' i l' i z aA ts' i j' oo s
civilizuotą	ts' i v' i l' i z Uo t aa
colių	ts Oo l' uu
dabar	d a b A R
dabartinio	d a b a r' t' I n' oo
dabartinė	d a b a r' t' I n' ee
dabartinę	d a b a r' t' I n' ea
daiktus	d Aa j k t u s
dainas	d a j n A s
dainava	d a j n a v A
dainavimo	d a j n aA v' i m oo
dainavo	d a j n aA v oo
dainingesnės	d a j n' i n' g' e s' n' ee s
dainingos	d a j n' I n g oo s
dainininkai	d a j n' i n' I N k a j
dainininkas	d a j n' i n' I N k a s
dainoms	d a j n Oo m s
dainos	d a j n oO s
dainose	d a j n oo s' E
dainuoja	d a j n Uo j' e
dainuojama	d a j n Uo j' e m a
dainuojamas	d a j n Uo j' e m a s
dainuojame	d a j n Uo j' e m' e
dainuojamos	d a j n Uo j' e m oo s
dainuojant	d a j n Uo j' e n t
dainuojančių	d a j n Uo j' e n' tS' uu
dainuojančiųjų	d a j n Uo j' e n' tS' uu j' uu
dainuoti	d a j n Uo t' i
dainų	d a j n uU
dali	d a l' I
dalia	d a l' E
dalimi	d a l' i m' I
dalimis	d a l' i m' I s
daline	d a l' i n' E
dalis	d a l' I s
dalią	d aA l' ea
dalių	d a l' uU
dalyje	d a l' ii j' E
dalys	d aA l' ii s
dalį	d aA l' ii
dangalas	d A N g a l a s
dantis	d a n' t' I s
dantyta	d a n' t' Ii t a
dar	d Aa r
darbai	d a r b a j
darbas	d Aa r b a s
darbininku	d a r' b' i n' i n k U
darbininkų	d a r' b' i n' I N k uu
darbus	d Aa r b u s
darbą	d a r b aa
darbų	d a r b uU
daro	d aA r oo
daroma	d aA r oo m a
daromi	d aA r oo m' i
darymas	d aA r' ii m a s
daryti	d a r' Ii t' i
datos	d aA t oo s
datuojamos	d a t Uo j' e m oo s
daug	d A W k
daugelio	d A W g' e l' oo
daugelis	d A W g' e l' i s
daugelyje	d A W g' e l' ii j' e
daugelį	d A W g' e l' ii
daugiaaukštį	d a w g' e A W k' S' t' ii
daugiabalses	d a w g' e b a l' s' E s
daugiakampius	d a w g' e k a m' p' u s
daugiaspalvė	d a w g' e s p A L' v' ee
daugiau	d a w g' E W
daugiausia	d a w g' Ea w s' e
daugiausiai	d a w g' Ea w s' e j
dauguma	d a w g u m A
daugumos	d a w g u m oO s
daugumą	d A W g u m aa
daugybė	d a w g' Ii b' ee
daugybės	d a w g' Ii b' ee s
daugybę	d a w g' Ii b' ea
dažna	d a Z n a
dažnai	d a Z n a j
dažnam	d a Z n Aa m
dažnas	d aA Z n a s
dažniau	d a Z' n' E W
dažniausi	d a Z' n' Ea w s' i
dažniausia	d a Z' n' Ea w s' e
dažniausiai	d a Z' n' Ea w s' e j
dedamas	d' eA d a m a s
degančio	d' eA g a n' tS' oo
deginant	d' eA g' i n a n t
dekoratyvinių	d' e k o r a t' iI v' i n' uu
deoksiribonukleorūgščių	d' e oo k' s' i r' i b oo n u k' l' e oo r uu k' S' tS' uu
deoksiribonuklieorūgščių	d' e oo k' s' i r' i b oo n u k' l' ie oo r uu k' S' tS' uu
derliaus	d' E R' l' e w s
derlingose	d' e r' l' I n g oo s' e
devintaisiais	d' e v' i n t A J s' e j s
devintame	d' e v' i n t a m' E
devyni	d' e v' ii n' I
devyniasdešimt	d' e v' Ii n' e z' d' e S' i m t
devynioliktam	d' e v' ii n' Oo l' i k t a m
devynioliktame	d' e v' ii n' Oo l' i k t a m' e
devyniolikto	d' e v' ii n' Oo l' i k t oo
devynios	d' e v' Ii n' oo s
devynis	d' e v' Ii n' i s
devynių	d' e v' ii n' uU
dešimt	d' eA S' i m t
dešimties	d' e S' i m' t' iE s
dešimtis	d' eA S' i m' t' i s
dešimtmeti	d' e S' I M' t' m' e t' i
dešimtmetį	d' e S' I M' t' m' e t' ii
dešimtmečiais	d' e S' I M' t' m' e tS' e j s
dešimtmečio	d' e S' I M' t' m' e tS' oo
dešimtuosius	d' e S' i m t Uo s' u s
dešiniajame	d' e S' i n' eA j' e m' e
dideli	d' i d' e l' I
dideliam	d' i d' e l' Ea m
dideliems	d' i d' e l' Ie m s
didelius	d' I d' e l' u s
didelių	d' i d' e l' uU
didelė	d' I d' e l' ee
didelės	d' i d' e l' ee s
didelę	d' I d' e l' ea
didesni	d' i d' e s' n' I
didesnis	d' i d' E s' n' i s
didesnė	d' i d' E s' n' ee
didumą	d' i d u m aa
diduomenės	d' i d Uo m' e n' ee s
didysis	d' i d' iI s' i s
didėti	d' i d' Ee t' i
didįjį	d' I d' ii j' ii
didžiajam	d' i dZ' Ea j' e m
didžiausias	d' i dZ' Ea w s' e s
didžiausio	d' i dZ' Ea w s' oo
didžiausių	d' i dZ' Ea w s' uu
didžioji	d' i dZ' Oo j' i
didžiojo	d' I dZ' oo j' oo
didžiosios	d' i dZ' oO s' oo s
didžiules	d' i dZ' u l' E s
didžiuliai	d' i dZ' U l' e j
didžiulis	d' i dZ' U l' i s
didžiulius	d' i dZ' u l' U s
didžiulių	d' i dZ' U l' uu
didžiulė	d' i dZ' U l' ee
didžiulę	d' i dZ' U l' ea
didžiuosius	d' i dZ' Uo s' u s
didžiąją	d' I dZ' ea j' ea
didžių	d' i dZ' uU
didžiųjų	d' i dZ' uU j' uu
diena	d' ie n A
dienas	d' ie n A s
dienoms	d' ie n Oo m s
dienovidinio	d' ie n Oo v' i d' i n' oo
dieną	d' iE n aa
dienų	d' ie n uU
dievais	d' ie v A J s
dievas	d' iE v a s
dievo	d' iE v oo
dievų	d' ie v uU
dinamitu	d' i n a m' i t U
dinozaurų	d' i n o z Aa w r uu
dirba	d' I r b a
dirbinių	d' i r' b' i n' uU
dirbo	d' I r b oo
dirbta	d' i r p t a
dirbtinis	d' i r' p' t' I n' i s
dirbtuvės	d' i r p t U v' ee s
dokumentuot	d o k u m' e n t Uo t
dokumentuoti	d o k u m' e n t Uo t' i
dominuojančia	d o m' i n Uo j' e n' tS' e
draudžiami	d r a w dZ' e m' I
drebėjimai	d' r' e b' Ee j' i m a j
drebėjimams	d' r' e b' Ee j' i m a m s
drebėjimas	d' r' e b' Ee j' i m a s
drebėjimus	d' r' e b' Ee j' i m u s
driekiasi	d' r' iE k' e s' i
driežai	d' r' ie Z a j
drožinių	d r oo Z' i n' uU
druskingu	d r u s' k' I n g u
druskų	d r U s k uu
du	d U
dubens	d u b' E N s
dugnas	d U g n a s
dugne	d u g' n' E
dukters	d u k' t' E R s
dulkių	d u l' k' uu
dumblo	d U M b l oo
duoda	d Uo d a
duomenimis	d uo m' e n' i m' I s
duomenis	d Uo m' e n' i s
durimis	d U r' i m' i s
durpynuose	d u r' p' Ii n uo s' e
dvaro	d v aA r oo
dvasininkų	d v aA s' i n' i n k uu
dvelkiantis	d' v' E L' k' e n' t' i s
dvi	d' v' I
dvidešimt	d' v' I d' e S' i m t
dvidešimtajame	d' v' i d' e S' i m t aA j' e m' e
dvidešimtame	d' v' i d' e S' i m t a m' E
dvidešimties	d' v' I d' e S' i m' t' ie s
dvidešimto	d' v' i d' e S' I M t oo
dvidešimtojo	d' v' i d' e S' I M t oo j' oo
dviejų	d' v' ie j' uU
dviem	d' v' Ie m
dvigubai	d' v' I g u b a j
dvigubus	d' v' I g u b u s
dvigubų	d' v' I g u b uu
dvylika	d' v' Ii l' i k a
dvyliktame	d' v' Ii l' i k t a m' e
dvyliktas	d' v' Ii l' i k t a s
dydis	d' iI d' i s
dydį	d' iI d' ii
dydžiai	d' iI dZ' e j
dydžiais	d' iI dZ' e j s
dydžio	d' iI dZ' oo
dykumoje	d' ii k u m oo j' E
dykumos	d' ii k u m oO s
dykumą	d' iI k u m aa
dykumų	d' ii k u m uU
dzūkai	dz uU k a j
dzūkams	dz uU k a m s
dzūkija	dz uu k' i j' E
dzūkijos	dz uu k' I j' oo s
dzūkų	dz uU k uu
dėjo	d' Ee j' oo
dėka	d' ee k A
dėl	d' ee l
dūmai	d uu m a j
dūmu	d Uu m u
dūmų	d uu m uu
egipto	e g' I p t oo
egiptui	e g' I p t u j
egzistavo	e g' z' i s t aA v oo
egzistuoti	e g' z' i s t Uo t' i
eilėmis	e j l' ee m' I s
ekonominis	e k o n O m' i n' i s
ekonominių	e k o n O m' i n' uu
ekspedicija	e k' s' p' e d' I ts' i j' e
ekspedicijos	e k' s' p' e d' I ts' i j' oo s
ekspediciją	e k' s' p' e d' I ts' i j' ea
eksponuojami	e k s p o n Uo j' e m' i
elementai	e l' e m' E N t a j
elgtis	E L' k' t' i s
emalis	e m aA l' i s
era	e r A
erelis	e r' eA l' i s
erozija	e r O z' i j' e
erą	E r aa
erškėtis	e r' S' k' eE t' i s
esamų	e s a m uU
esant	eA s a n t
esantis	eA s a n' t' i s
esančiomis	eA s a n' tS' oo m' i s
esančios	eA s a n' tS' oo s
esančiuose	eA s a n' tS' uo s' e
esančių	eA s a n' tS' uu
esate	eA s a t' e
eskizai	e s' k' I z a j
esmės	e s' m' ee s
estijos	E s' t' i j' oo s
estiją	E s' t' i j' ea
esu	e s U
etapas	e t aA p a s
etinių	E t' i n' uu
etninio	E t' n' i n' oo
etninių	E t' n' i n' uu
europietis	e w r o p' iE t' i s
europoje	e w r O p oo j' e
europos	e w r O p oo s
ežeras	eA Z' e r a s
ežere	e Z' e r' E
ežero	eA Z' e r oo
ežeru	eA Z' e r u
ežerus	eA Z' e r u s
ežerą	eA Z' e r aa
ežerų	e Z' e r uU
ežys	e Z' iI s
faktai	f aA k t a j
faraonams	f a r a O n a m s
faraonas	f a r a O n a s
faraonų	f a r a O n uu
faunai	f Aa w n a j
feodalai	f' e o d aA l a j
ferma	f' E r m a
figūra	f' i g uu r A
figūras	f' i g uu r A s
figūros	f' i g uU r oo s
figūrų	f' i g uU r uu
filosofiją	f' i l o s O f' i j' ea
fiordai	f' O r d a j
fiordas	f' O r d a s
fiorduose	f' O r d uo s' e
fiordų	f' O r d uu
flamingas	f l a m' I n g a s
florai	f l O r a j
folklore	f o l k l o r' E
folkloro	f o l k l O r oo
forma	f O r m a
formavimosi	f o r m aA v' i m oo s' i
formavosi	f o r m aA v oo s' i
formos	f O r m oo s
formuojasi	f o r m Uo j' e s' i
formuot	f o r m Uo t
formuotas	f o r m Uo t a s
formuoti	f o r m Uo t' i
formų	f O r m uu
fregata	f' r' e g a t A
freskomis	f' r' E s k oo m' i s
freskų	f' r' E s k uu
frontoną	f r o n t O n aa
gabalas	g aA b a l a s
gabalų	g a b a l uU
gabarituose	g a b a r' I t uo s' e
gabenami	g a b' eA n a m' i
gaida	g a j d A
gaidą	g A J d aa
galbūt	g a l b Uu t
gale	g a l' E
gali	g aA l' i
galima	g aA l' i m a
galimybės	g a l' i m' Ii b' ee s
galimų	g a l' i m uU
galingas	g a l' I n g a s
galingi	g a l' I n' g' i
galią	g aA l' ea
galutinai	g a l u t' i n A J
galva	g a l v A
galvą	g Aa l v aa
galėjo	g a l' Ee j' oo
galėtumėte	g a l' Ee t u m' ee t' e
galėtų	g a l' Ee t uu
galėčiau	g a l' Ee tS' e w
galų	g a l uU
gaminamos	g a m' I n a m oo s
gamtai	g A M t a j
gamtininkai	g A M' t' i n' i n k a j
gamtinių	g a m' t' I n' uu
gamtos	g a m t oO s
gamtovaizdį	g a m t Oo v a j z' d' ii
gana	g a n A
ganėtinai	g a n' Ee t' i n a j
garbei	g A R' b' e j
garnio	g A R' n' oo
garsai	g a r s A J
garsas	g A R s a s
garsažodžių	g a r s aA Z oo dZ' uu
garso	g A R s oo
garsus	g a r s U s
gatvių	g aA t' v' uu
gaubia	g A W b' e
gaudo	g Aa w d oo
gaudyklėse	g a w d' iI k' l' ee s' e
gaudyti	g Aa w d' ii t' i
gaują	g A W j' ea
gausiai	g A W s' e j
gausu	g a w s U
gausumą	g a w s U m aa
gauti	g Aa w t' i
gavo	g aA v oo
gebantis	g' eA b a n' t' i s
gedimino	g' e d' i m' I n oo
geležinėmis	g' e l' e Z' I n' ee m' i s
generolo	g' e n' e r oO l oo
generolų	g' e n' e r oO l uu
genčių	g' e n' tS' uU
geografinė	g' e o g r aA f' i n' ee
geologų	g' e o l O g uu
geometrines	g' e o m' E t' r' i n' e s
geometrinių	g' e o m' E t' r' i n' uu
gerai	g' e r A J
gerbiami	g' e r' b' e m' I
geriau	g' e r' E W
geriausia	g' e r' Ea w s' e
geriu	g' e r' U
gerklę	g' Ea r' k' l' ea
gero	g' eA r oo
gerokai	g' e r Oo k a j
gervė	g' Ea r' v' ee
gerą	g' eA r aa
gestu	g' e s t U
gestų	g' E s t uu
gido	g' I d oo
giesmės	g' ie s' m' ee s
gigantiški	g' i g Aa n' t' i S' k' i
gilesnis	g' i l' E s' n' i s
giliausi	g' i l' Ea w s' i
giliausia	g' i l' Ea w s' e
giliausias	g' i l' Ea w s' e s
gilius	g' i l' U s
gilyn	g' i l' iI n
giminių	g' i m' i n' uU
gimtadienis	g' i m t aA d' ie n' i s
gindami	g' i n d a m' I
ginklai	g' I N k l a j
ginčai	g' I N tS a j
girdimas	g' I R' d' i m a s
glūdi	g l uU d' i
gniaužiantis	g' n' Ea w Z' e n' t' i s
gotikos	g O t' i k oo s
graikijos	g r A J k' i j' oo s
graikiško	g r A J k' i S k oo
graikiškojo	g r A J k' i S k oo j' oo
graikų	g r A J k uu
gramų	g r aA m uu
grandinė	g r a n' d' I n' ee
grandinės	g r a n' d' I n' ee s
grandinę	g r a n' d' I n' ea
grasint	g r a s' I n t
grasinti	g r a s' I n' t' i
graužti	g r Aa w S' t' i
gražios	g r a Z' oo s
greitai	g' r' E J t a j
greitam	g' r' e j t Aa m
greitesnė	g' r' e j t' E s' n' ee
greitis	g' r' E J t' i s
greitį	g' r' E J t' ii
grenlandijoje	g' r' e n l Aa n' d' i j' oo j' e
greta	g' r' e t A
gretimose	g' r' e t' i m oo s' E
griaučių	g' r' Ea w tS' uu
griežtai	g' r' ie S t a j
grindų	g' r' i n d uU
grioveliai	g' r' oo v' eA l' e j
grioviai	g' r' oo v' E J
griovius	g' r' oo v' U s
grobiui	g r oO b' u j
grobį	g r oO b' ii
groži	g r oO Z' i
grublėtą	g r u b' l' Ee t aa
grumstas	g r U M s t a s
gruntas	g r U N t a s
grupe	g r u p' E
grupuojami	g r u p Uo j' e m' i
grupė	g r U p' ee
grupėmis	g r U p' ee m' i s
grupės	g r U p' ee s
gruzinų	g r u z' I n uu
grąžą	g r aA Z aa
grėsmę	g' r' eE s' m' ea
grėsė	g' r' eE s' ee
gręžė	g' r' eA Z' ee
gubernatorius	g u b' e r n aA t o r' u s
gulyklos	g u l' iI k l oo s
gulyklų	g u l' iI k l uu
gydymo	g' Ii d' ii m oo
gyli	g' iI l' i
gylio	g' iI l' oo
gylis	g' iI l' i s
gyly	g' iI l' ii
gylyje	g' iI l' ii j' e
gylį	g' iI l' ii
gynimo	g' ii n' I m oo
gynusios	g' Ii n u s' oo s
gynyba	g' ii n' Ii b a
gynybai	g' ii n' Ii b a j
gynybiniai	g' ii n' Ii b' i n' e j
gynybiniais	g' ii n' Ii b' i n' e j s
gynybinis	g' ii n' Ii b' i n' i s
gynybinių	g' ii n' Ii b' i n' uu
gynybinė	g' ii n' Ii b' i n' ee
gynybinį	g' ii n' Ii b' i n' ii
gynybą	g' ii n' Ii b aa
gyvas	g' Ii v a s
gyvena	g' ii v' eA n a
gyvenamieji	g' ii v' eA n a m' ie j' i
gyvenamojoje	g' ii v' eA n a m oo j' oo j' e
gyvenamose	g' ii v' eA n a m oo s' e
gyvenamuose	g' ii v' eA n a m uo s' e
gyvenamųjų	g' ii v' eA n a m uu j' uu
gyvenančių	g' ii v' eA n a n' tS' uu
gyvenimai	g' ii v' eA n' i m a j
gyvenimas	g' ii v' eA n' i m a s
gyvenimo	g' ii v' eA n' i m oo
gyvenimu	g' ii v' eA n' i m u
gyvenimui	g' ii v' eA n' i m u j
gyvenimą	g' ii v' eA n' i m aa
gyveno	g' ii v' eA n oo
gyvent	g' ii v' Ea n t
gyventi	g' ii v' Ea n' t' i
gyventoj	g' ii v' Ea n t oo j
gyventojai	g' ii v' Ea n t oo j' e j
gyventojams	g' ii v' Ea n t oo j' e m s
gyventoju	g' ii v' Ea n t oo j' u
gyventojų	g' ii v' Ea n t oo j' uu
gyvenu	g' ii v' e n U
gyvenusi	g' ii v' eA n u s' i
gyvenusių	g' ii v' eA n u s' uu
gyvenviete	g' ii v' Ea n' v' ie t' e
gyvenvietes	g' ii v' Ea n' v' ie t' e s
gyvenvietė	g' ii v' Ea n' v' ie t' ee
gyvoji	g' ii v Oo j' i
gyvojoje	g' ii v oO j' oo j' e
gyvsidabris	g' Ii v' s' i d a b' r' i s
gyvuliai	g' ii v u l' E J
gyvuliams	g' ii v u l' Ea m s
gyvulių	g' ii v u l' uU
gyvybės	g' ii v' Ii b' ee s
gyvūnai	g' ii v uU n a j
gyvūniją	g' ii v uu n' I j' ea
gyvūnu	g' ii v uu n U
gyvūnus	g' ii v uu n U s
gyvūnų	g' ii v uU n uu
gyvų	g' ii v uU
gėlavandenis	g' ee l a v a n' d' eA n' i s
gėlo	g' eE l oo
harmonija	h a r m O n' i j' e
helio	h' E l' oo
herbai	h' E r b a j
hetitu	h' e t' i t u
hetitų	h' e t' i t uu
hidroelektrinę	h' i d r o e l' e k' t' r' I n' ea
hieroglifais	h' ie r O g' l' i f a j s
himnai	h' I m n a j
hipotezė	h' i p o t' E z' ee
hipotezę	h' i p o t' E z' ea
horizonte	h o r' i z O n' t' e
hunai	h U n a j
ie	j'ie
ieškanti	j'Ie S k a n' t' i
ieškotoj	j'ie S k Oo t oo j
ieškotojai	j'ie S k Oo t oo j' e j
iki	i k' i
ikonų	i k O n uu
ilgai	i l g a j
ilgas	I l g a s
ilgiausia	i l' g' Ea w s' e
ilgiausias	i l' g' Ea w s' e s
ilgiausios	i l' g' Ea w s' oo s
ilgio	I L' g' oo
ilgis	I L' g' i s
ilgiu	i l' g' U
ilgiui	I L' g' u j
ilgius	i l' g' U s
ilgo	I l g oo
ilgą	I l g aa
ilgų	i l g uU
ilsisi	I l' s' i s' i
ima	I m a
imdavo	I M d a v oo
imperatoriai	i m' p' e r aA t o r' e j
imperatoriaus	i m' p' e r aA t o r' e w s
imperatorius	i m' p' e r aA t o r' u s
imperatorių	i m' p' e r aA t o r' uu
imperatorė	i m' p' e r aA t o r' ee
imperija	i m' p' E r' i j' e
imperijoje	i m' p' E r' i j' oo j' e
imperijos	i m' p' E r' i j' oo s
impozantiškų	i m p o z Aa n' t' i S k uu
imta	i m t a
imti	I M' t' i
indais	I N d a j s
indėnai	i n' d' Ee n a j
infekcinės	i n' f' E k' ts' i n' ee s
informaciją	i n f o r m aA ts' i j' ea
ingų	I n g uu
iniciatyva	i n' i ts' i a t' ii v A
inkai	I n k a j
inku	I n k u
inkų	I n k uu
instrukcijos	i n s t r U k' ts' i j' oo s
instrumentai	i n s t r u m' E N t a j
instrumentais	i n s t r u m' E N t a j s
instrumentų	i n s t r u m' E N t uu
intarpai	I N t a r p a j
intensyviai	i n' t' e n' s' ii v' E J
intensyvios	i n' t' e n' s' ii v' oo s
interesams	i n' t' e r' E s a m s
ir	i r
irano	i r aA n oo
islamo	i s l aA m oo
islamą	i s l aA m aa
islandijoje	i s l Aa n' d' i j' oo j' e
ispanu	i s p a n U
ispanų	i s p aA n uu
istorija	i s t O r' i j' e
istorijoje	i s t O r' i j' oo j' e
istoriją	i s t O r' i j' ea
istorikas	i s t O r' i k a s
istoriniai	i s t O r' i n' e j
istorinio	i s t O r' i n' oo
istorinis	i s t O r' i n' i s
istorinius	i s t O r' i n' u s
istorinė	i s t O r' i n' ee
itin	I t' i n
iš	i S
išaugo	i S Aa w g oo
išaugus	i S Aa w g u s
išbarstyti	i Z b a r' s' t' Ii t' i
išdabinta	i Z d a b' I n t a
išduodamas	i Z d Uo d a m a s
išdėstyti	i Z' d' Ee s' t' ii t' i
išdėstytų	i Z' d' Ee s' t' ii t uu
išdžiovintų	i Z' dZ' oo v' I n t uu
išgaubti	i Z g a w p' t' i
išgraužęs	i Z g r Aa w Z' ea s
išgrįstą	I Z' g' r' ii s t aa
išgyvendavo	i Z' g' ii v' Ea n d a v oo
išgyventi	i Z' g' ii v' Ea n' t' i
išilgai	i S' i l g A J
iškart	i S k A R t
iškilus	i S' k' i l u s
iškilusi	i S' k' I l u s' i
iškišamos	I S' k' i S a m oo s
išklotų	i S k l Oo t uu
išlaikyti	i S l a j k' Ii t' i
išlieka	i S' l' iE k a
išliko	i S' l' I k oo
išlikę	i S' l' I k' ea
išlygino	i S' l' Ii g' i n oo
išmargintos	i S m Aa r' g' i n t oo s
išmatuota	i S m a t Uo t a
išmatuotas	i S m a t Uo t a s
išmatuoti	i S m a t Uo t' i
išmintingas	i S' m' i n' t' I n g a s
išmėginti	i S' m' ee g' I n' t' i
išnyko	i S' n' iI k oo
išnyks	i S' n' iI k s
išnykę	i S' n' iI k' ea
išorinis	i S oo r' I n' i s
išorės	I S oo r' ee s
išorę	I S oo r' ea
išpildymo	i S' p' I l' d' ii m oo
išpjauna	i S' p' j' Ea w n a
išplėsti	i S' p' l' eE s' t' i
išradimas	i S r a d' I m a s
išradimus	i S r a d' i m U s
išraizgę	i S r A J z' g' ea
išrastas	I S r a s t a s
išrastų	i S r A s t uu
išraustu	i S r a w s t U
išraustų	i S r A W s t uu
išrikiuota	i S' r' i k' Uo t a
išryškėja	i S' r' ii S' k' Ee j' e
išsaugoti	i S s Aa w g oo t' i
išsidėstę	i S' s' i d' Ee s' t' ea
išsidėstęs	i S' s' i d' Ee s' t' ea s
išsilaipino	i S' s' i l a j p' I n oo
išsilavinusi	i S' s' i l aA v' i n u s' i
išsiliejo	i S' s' i l' Ie j' oo
išsilydžiusioms	i S' s' i l' Ii dZ' u s' oo m s
išsiplėtė	i S' s' I p' l' ee t' ee
išsiruošia	i S' s' i r uO S' e
išsiskiria	i S' s' I s' k' i r' e
išskirti	i S' s' k' I r' t' i
išskobtos	i S s k oo p t oo s
ištirpimo	i S' t' i r' p' I m oo
ištirta	i S' t' I r t a
ištisinę	i S' t' i s' I n' ea
ištisus	I S' t' i s u s
ištremta	i S' t' r' e m t a
ištyrė	i S' t' Ii r' ee
išvadą	I S v a d aa
išvarpyta	i S v a r' p' Ii t a
išvysto	i S' v' Ii s t oo
ja	j' E
jam	j' Ea m
jame	j' e m' E
japonai	j' e p O n a j
japonijoje	j' e p O n' i j' oo j' e
japonijos	j' e p O n' i j' oo s
jas	j' E s
jau	j' e w
jauna	j' e w n a
jaunikliai	j' e w n' I k' l' e j
jauniklius	j' e w n' i k' l' U s
jauniklių	j' e w n' I k' l' uu
jaunuolynų	j' e w n uo l' Ii n uu
jausmus	j' e w s m U s
jav	j' e v
jei	j' Ea j
ji	j' I
jie	j' iE
jiems	j' Ie m s
jis	j' I s
jo	j' oO
jog	j' oo k
joje	j' oo j' E
jok	j' Oo k
jokių	j' oo k' uU
jomis	j' oo m' I s
joms	j' Oo m s
jos	j' oO s
joti	j' Oo t' i
juda	j' U d a
judrus	j' u d r U s
judėjimo	j' u d' Ee j' i m oo
jums	j' U m s
jungiančių	j' U n' g' e n' tS' uu
jungiasi	j' U n' g' e s' i
jungtinėse	j' u n' k' t' I n' ee s' e
juodkalnijoje	j' uo t k a l' n' I j' oo j' e
juos	j' uO s
juose	j' uo s' E
juosia	j' Uo s' e
juostų	j' Uo s t uu
ją	j' eA
jį	j' iI
jūra	j' Uu r a
jūras	j' Uu r a s
jūros	j' Uu r oo s
jų	j' uU
kaba	k aA b a
kablelis	k a b' l' eA l' i s
kad	k a t
kada	k a d A
kadaise	k a d Aa j s' e
kai	k a j
kailiu	k Aa j l' u
kaimai	k Aa j m a j
kaimynai	k a j m' Ii n a j
kaimynus	k a j m' Ii n u s
kaimynystėje	k a j m' ii n' iI s' t' ee j' e
kaimynystės	k a j m' ii n' iI s' t' ee s
kaip	k A J p
kaklas	k aA k l a s
kalba	k a l b a
kalbančia	k A L b a n' tS' e
kalboje	k a l b oo j' E
kalbos	k a l b oO s
kalbų	k a l b uU
kalendorines	k a l' e n d oO r' i n' e s
kalinių	k a l' i n' uU
kalnai	k a l n A J
kalnakasei	k a l n aA k a s' e j
kalnakasiai	k a l n a k a s' E J
kalnas	k Aa l n a s
kalne	k a l' n' E
kalno	k Aa l n oo
kalnu	k Aa l n u
kalnuose	k a l n uo s' E
kalnuotomis	k a l n Uo t oo m' i s
kalnus	k Aa l n u s
kalną	k Aa l n aa
kalnų	k a l n uU
kalvagūbrius	k a l v aA g uu b' r' u s
kalvas	k a l v A s
kalvystė	k a l' v' iI s' t' ee
kalvystės	k a l' v' iI s' t' ee s
kalėjimas	k a l' Ee j' i m a s
kam	k Aa m
kambarys	k a m b a r' iI s
kampelių	k a m' p' eA l' uu
kanadoj	k a n aA d oo j
kanadoje	k a n aA d oo j' e
kanalo	k a n aA l oo
kanalu	k a n a l U
kanalų	k a n aA l uu
kandžiai	k A N' dZ' e j
kanjonas	k a n' j' O n a s
kanjono	k a n' j' O n oo
kanjoną	k a n' j' O n aa
kankinės	k a n' k' i n' ee s
kapai	k a p a j
kapavietės	k a p aA v' ie t' ee s
kapavietę	k a p aA v' ie t' ea
kapaviečių	k a p aA v' ie tS' uu
kapinynas	k a p' i n' Ii n a s
kaprizingai	k a p' r' i z' I n g a j
kapsų	k A p s uu
karai	k a r A J
karaliams	k a r aA l' e m s
karaliaus	k a r aA l' e w s
karalienėms	k a r a l' Ie n' ee m s
karalienės	k a r a l' Ie n' ee s
karaliui	k a r aA l' u j
karališkosios	k a r aA l' i S k oo s' oo s
karalių	k a r aA l' uu
karalyste	k a r a l' ii s' t' E
karalystė	k a r a l' iI s' t' ee
karalystę	k a r a l' iI s' t' ea
karas	k aA r a s
karavanu	k a r a v a n U
karavanų	k a r a v aA n uu
karbonato	k a r b o n aA t oo
kareivinėmis	k a r' e j v' I n' ee m' i s
kareiviu	k a r' e j v' U
kareivių	k a r' E J v' uu
kariai	k a r' E J
kariauna	k a r' e w n A
karių	k a r' uU
karo	k aA r oo
kartais	k A R t a j s
karto	k A R t oo
kartojasi	k a r t Oo j' e s' i
kartu	k a r t U
kartus	k a r t U s
kartą	k A R t aa
kartų	k a r t uu
karus	k a r U s
karštyje	k A R' S' t' ii j' e
kas	k A s
kasa	k a s a
kasant	k aA s a n t
kasdami	k a z d a m' I
kaskadų	k a s k aA d uu
kasyklų	k a s' iI k l uu
kat	k a t
katalikais	k a t a l' I k a j s
katastrofiškai	k a t a s t r O f' i S k a j
katastrofiškas	k a t a s t r O f' i S k a s
katu	k a t U
kaulus	k Aa w l u s
kaupia	k A W p' e
kažin	k a Z' I n
kažkam	k a S k Aa m
kažkur	k a S k U R
keitimai	k' e j t' I m a j
keičiasi	k' E J tS' e s' i
keletas	k' eA l' e t a s
keletu	k' eA l' e t u
keletą	k' eA l' e t aa
keli	k' e l' I
keliais	k' e l' E J s
keliama	k' e l' e m a
kelias	k' e l' e s
keliaudami	k' e l' Ea w d a m' i
keliauja	k' e l' Ea w j' e
keliaujančių	k' e l' Ea w j' e n' tS' uu
keliaujančiųjų	k' e l' Ea w j' e n' tS' uu j' uu
keliautojai	k' e l' Ea w t oo j' e j
kelio	k' eA l' oo
kelioms	k' e l' Oo m s
kelionę	k' e l' oO n' ea
kelios	k' eA l' oo s
kelis	k' e l' I s
kelių	k' e l' uU
kelmas	k' Ea l m a s
kelti	k' Ea l' t' i
keramikos	k' e r aA m' i k oo s
kernavė	k' e r n a v' eE
kernavėje	k' e r n a v' ee j' E
kernavės	k' e r n a v' ee s
kernius	k' E R' n' u s
kerta	k' E R t a
kertiniais	k' e r' t' I n' e j s
keterų	k' e t' e r uU
keturi	k' e t u r' I
keturiais	k' e t u r' E J s
keturias	k' eA t u r' e s
keturiasdešimt	k' eA t u r' e z' d' e S' i m t
keturiasdešimtaisiais	k' e t u r' e z' d' e S' i m t A J s' e j s
keturiasdešimties	k' eA t u r' e z' d' e S' i m' t' ie s
keturiese	k' e t u r' Ie s' e
keturiolikos	k' e t u r' Oo l' i k oo s
keturiolikto	k' e t u r' Oo l' i k t oo
keturiose	k' e t u r' oo s' E
keturis	k' eA t u r' i s
keturių	k' e t u r' uU
kiauninių	k' E W n' i n' uu
kiaunių	k' Ea w n' uu
kiaunės	k' Ea w n' ee s
kiaušinius	k' e w S' i n' U s
kiek	k' Ie k
kiekiai	k' iE k' e j
kiekviena	k' ie k' v' ie n A
kiekvienas	k' ie k' v' Ie n a s
kiekvienos	k' ie k' v' ie n oo s
kietas	k' Ie t a s
kietėjo	k' ie t' Ee j' oo
kilmėms	k' i l' m' Ee m s
kilmės	k' i l' m' ee s
kilogramo	k' i l o g r aA m oo
kilogramus	k' i l o g r a m U s
kilogramų	k' i l o g r aA m uu
kilome	k' I l oo m' e
kilometrai	k' i l o m' E t r a j
kilometras	k' i l o m' E t r a s
kilometrinius	k' i l o m' E t' r' i n' u s
kilometro	k' i l o m' E t r oo
kilometru	k' i l o m' e t r U
kilometrus	k' i l o m' e t r U s
kilometrą	k' i l o m' E t r aa
kilometrų	k' i l o m' E t r uu
kilpas	k' I l p a s
kilti	k' I l' t' i
kilusi	k' I l u s' i
kinai	k' I n a j
kinijos	k' I n' i j' oo s
kinta	k' I N t a
kintamas	k' I N t a m a s
kinų	k' I n uu
kita	k' i t A
kitai	k' I t a j
kitaip	k' i t A J p
kitais	k' i t A J s
kitam	k' i t Aa m
kitas	k' i t a s
kiti	k' i t' I
kitimai	k' i t' I m a j
kito	k' I t oo
kitokie	k' i t Oo k' ie
kitos	k' i t oo s
kitose	k' i t oo s' E
kituose	k' i t uo s' E
kitur	k' i t U R
kitus	k' i t U s
kitą	k' I t aa
kitų	k' i t uU
kiškiai	k' I S' k' e j
kiškinių	k' I S' k' i n' uu
kiškis	k' I S' k' i s
kiškius	k' i S' k' U s
kiškių	k' I S' k' uu
kiškį	k' I S' k' ii
klajojo	k l a j' Oo j' oo
klajoję	k l a j' Oo j' ea
klajoklio	k l a j' oO k' l' oo
klajoklius	k l a j' oo k' l' U s
klajoklių	k l a j' oO k' l' uu
klanai	k l a n A J
klanų	k l a n uU
klasikiniame	k l a s' i k' I n' e m' e
klausimas	k l Aa w s' i m a s
klausimu	k l Aa w s' i m u
klausimų	k l Aa w s' i m uu
klausosi	k l A W s oo s' i
klausą	k l a w s aa
klesti	k' l' e s' t' i
klestinčiu	k' l' eA s' t' i n' tS' u
klimato	k' l' I m a t oo
klimatu	k' l' I m a t u
kliu	k' l' u
klodus	k l oo d U s
knygą	k' n' iI g aa
ko	k oO
kodeksų	k O d' e k s uu
kodėl	k oo d' eE l
kojomis	k Oo j' oo m' i s
kojų	k Oo j' uu
kokios	k oo k' oo s
kokius	k Oo k' u s
koks	k Oo k s
kokį	k Oo k' ii
kol	k oO l
kolekcija	k o l' E k' ts' i j' e
kolekcijomis	k o l' E k' ts' i j' oo m' i s
kolonistų	k o l o n' I s t uu
komiteto	k o m' i t' E t oo
kompiuterių	k o m' p' U t' e r' uu
kompleksas	k o m' p' l' E k s a s
komplekso	k o m' p' l' E k s oo
kompleksu	k o m' p' l' e k s U
kompleksą	k o m' p' l' E k s aa
kompleksų	k o m' p' l' E k s uu
kondoro	k o n d O r oo
konkreti	k o n' k' r' e t' I
konkretūs	k o n' k' r' E t uu s
konkrečius	k o n' k' r' e tS' U s
konkurentais	k o n k u r' E N t a j s
konkurentų	k o n k u r' E N t uu
konkuruoja	k o n k u r Uo j' e
konkuruojančius	k o n k u r Uo j' e n' tS' u s
konstitucija	k o n' s' t' i t U ts' i j' e
konstrukcija	k o n s t r U k' ts' i j' e
konstrukcijos	k o n s t r U k' ts' i j' oo s
konstrukciją	k o n s t r U k' ts' i j' ea
kontakto	k o n t aA k t oo
kontaktą	k o n t aA k t aa
kontrolės	k o n t r O l' ee s
kontūras	k O n t uu r a s
koralai	k o r aA l a j
koralų	k o r aA l uu
koridorius	k o r' I d oo r' u s
kosulio	k Oo s u l' oo
kosėju	k Oo s' ee j' u
kotryna	k o t' r' ii n A
kotrynos	k o t' r' iI n oo s
kovos	k oo v oO s
krante	k r a n' t' E
krantuose	k r a n t uo s' E
krantus	k r a n t U s
kraujagyslių	k r a w j' eA g' ii s' l' uu
kraujo	k r A W j' oo
kraštovaizdis	k r a S t Oo v a j z' d' i s
kraštovaizdžio	k r a S t Oo v a j Z' dZ' oo
kraštuose	k r a S t uo s' E
kraštą	k r aA S t aa
kraštų	k r a S t uU
kreives	k' r' e j v' E s
kremuotų	k' r' e m Uo t uu
krenta	k' r' E N t a
krepšelį	k' r' e p' S' eA l' ii
krepšys	k' r' e p' S' iI s
krikščioniško	k' r' i k' S' tS' Oo n' i S k oo
krikščioniškoji	k' r' i k' S' tS' Oo n' i S k oo j' i
krikščioniškojo	k' r' i k' S' tS' Oo n' i S k oo j' oo
krikščioniškos	k' r' i k' S' tS' Oo n' i S k oo s
krikščionišką	k' r' i k' S' tS' Oo n' i S k aa
krikščionių	k' r' i k' S' tS' Oo n' uu
krikščionybė	k' r' i k' S' tS' oo n' Ii b' ee
krikščionybės	k' r' i k' S' tS' oo n' Ii b' ee s
krikščionė	k' r' i k' S' tS' Oo n' ee
kriokliais	k' r' oo k' l' E J s
krioklio	k' r' oO k' l' oo
kriokliu	k' r' oo k' l' U
krioklių	k' r' oo k' l' uU
krioklyje	k' r' oo k' l' ii j' E
krioklys	k' r' oo k' l' iI s
krioklį	k' r' oO k' l' ii
kris	k' r' I s
kristų	k' r' I s t uu
kritikuojama	k' r' i t' i k Uo j' e m a
kritulių	k' r' i t u l' uU
krize	k' r' i z' E
krizę	k' r' I z' ea
kryptimis	k' r' ii p' t' i m' I s
kryžiai	k' r' iI Z' e j
kryžiaus	k' r' iI Z' e w s
kryžiuočiais	k' r' ii Z' uO tS' e j s
kryžiuočių	k' r' ii Z' uO tS' uu
kryžių	k' r' iI Z' uu
krūmas	k r Uu m a s
krūmo	k r Uu m oo
krūmų	k r Uu m uu
kultu	k U l t u
kultūrinį	k u l t uU r' i n' ii
kultūroje	k u l t uU r oo j' e
kultūros	k u l t uU r oo s
kunigaikštis	k u n' i g Aa j k' S' t' i s
kunigaikštyste	k u n' i g a j k' S' t' ii s' t' E
kunigaikštystės	k u n' i g a j k' S' t' iI s' t' ee s
kunigaikščių	k u n' i g Aa j k' S' tS' uu
kuomet	k uo m' E t
kupstas	k U p s t a s
kur	k U R
kuri	k u r' I
kuria	k u r' e
kuriais	k u r' E J s
kuriame	k u r' e m' E
kuriantis	k U r' e n' t' i s
kurias	k u r' E s
kurie	k u r' iE
kuriems	k u r' Ie m s
kurio	k u r' oO
kurioje	k u r' oo j' E
kurios	k u r' oO s
kuriose	k u r' oo s' E
kuris	k u r' I s
kuriuose	k u r' uo s' E
kurią	k u r' eA
kurių	k u r' uU
kurs	k U R s
kurso	k U r s oo
kursu	k U r s u
kurtis	k u r' t' i s
kurį	k u r' iI
kvadratiniai	k v a d r aA t' i n' e j
kvadratiniu	k v a d r aA t' i n' u
kvadratinių	k v a d r aA t' i n' uu
kvapą	k v aA p aa
kybo	k' Ii b oo
kyla	k' iI l a
ką	k aA
kėlimo	k' ee l' I m oo
kūnas	k Uu n a s
kūne	k Uu n' e
kūno	k Uu n oo
kūną	k Uu n aa
kūrė	k Uu r' ee
laba	l a b a
labai	l a b a j
labiau	l a b' E W
labiausiai	l a b' Ea w s' e j
laboratoriją	l a b o r a t O r' i j' ea
lai	l A J
laibas	l Aa j b a s
laidojami	l Aa j d oo j' e m' i
laidojimo	l Aa j d oo j' i m oo
laidoti	l Aa j d oo t' i
laikais	l a j k A J s
laikinas	l A J k' i n a s
laikinų	l a j k' i n uU
laikoma	l A J k oo m a
laikome	l A J k oo m' e
laikomi	l A J k oo m' i
laikomos	l A J k oo m oo s
laikosi	l A J k oo s' i
laikotarpi	l a j k Oo t a r' p' i
laikotarpiais	l a j k Oo t a r' p' e j s
laikotarpio	l a j k Oo t a r' p' oo
laikotarpis	l a j k Oo t a r' p' i s
laikotarpiu	l a j k Oo t a r' p' u
laikotarpyje	l a j k Oo t a r' p' ii j' e
laikotarpį	l a j k Oo t a r' p' ii
laiką	l a j k aa
laikų	l a j k uu
laimei	l Aa j m' e j
laimė	l Aa j m' ee
laipsnį	l Aa j p' s' n' ii
laiptai	l Aa j p t a j
laiptais	l Aa j p t a j s
laiptus	l Aa j p t u s
laiptų	l Aa j p t uu
laisvo	l A J s v oo
laivui	l A J v u j
laivų	l a j v uu
laiškus	l Aa j S k u s
langų	l a n g uU
lankas	l A N k a s
lanko	l A N k oo
lankomiausia	l a n k oo m' e w s' e
lankomiausių	l a n k oo m' e w s' uu
lankytinų	l a n' k' Ii t' i n uu
lankėsi	l A N' k' ee s' i
lapes	l a p' E s
lapės	l aA p' ee s
latvijos	l aA t' v' i j' oo s
latviją	l aA t' v' i j' ea
laukiniai	l a w k' I n' e j
lauko	l A W k oo
laukuose	l a w k uo s' E
laukus	l a w k U s
laukų	l a w k uU
laupo	l A W p oo
laviną	l aA v' i n aa
lavos	l aA v oo s
ledinė	l' e d' I n' ee
ledo	l' eA d oo
ledu	l' e d U
ledynai	l' e d' Ii n a j
ledynas	l' e d' Ii n a s
ledyne	l' e d' Ii n' e
ledynei	l' e d' iI n' e j
ledyno	l' e d' Ii n oo
ledynų	l' e d' Ii n uu
legenda	l' e g' e n d A
legendos	l' e g' E N d oo s
legendą	l' e g' E N d aa
legendų	l' e g' E N d uu
leidimas	l' e j d' I m a s
leido	l' Ea j d oo
leidžiasi	l' Ea j dZ' e s' i
leisdavo	l' Ea j z d a v oo
lengva	l' e n g v a
lengvai	l' e n g v a j
lenkai	l' Ea n k a j
lenkijai	l' Ea n' k' i j' e j
liaudies	l' Ea w d' ie s
liaukų	l' E W k uu
liekana	l' iE k a n a
liekanos	l' iE k a n oo s
liekanų	l' iE k a n uu
liemenį	l' Ie m' e n' ii
liepsnoje	l' ie p s n oo j' E
lietuviškieji	l' ie t U v' i S' k' ie j' i
lietuviškos	l' ie t U v' i S k oo s
lietuvių	l' ie t U v' uu
lietuvoje	l' ie t u v oo j' E
lietuvos	l' ie t u v oO s
lietuvą	l' Ie t u v aa
lietūs	l' Ie t uu s
ligos	l' i g oO s
ligoti	l' i g Oo t' i
ligotus	l' i g Oo t u s
ligų	l' i g uU
likdavo	l' I g d a v oo
liko	l' I k oo
linija	l' I n' i j' e
linijas	l' I n' i j' e s
linijos	l' I n' i j' oo s
linksmos	l' i n k s m oo s
linkę	l' I N' k' ea
liūdesys	l' uu d' e s' iI s
liūdnos	l' uu d n oo s
liūtas	l' uU t a s
liūčių	l' Uu tS' uu
logiška	l O g' i S k a
logiškas	l O g' i S k a s
loja	l Oo j' e
lokiais	l oo k' E J s
lotyniškojo	l oo t' iI n' i S k oo j' oo
lubų	l u b uU
luitai	l U J t a j
luito	l U J t oo
luitų	l U J t uu
luomai	l Uo m a j
luomus	l Uo m u s
lyderio	l' Ii d' e r' oo
lygi	l' ii g' I
lygiadienius	l' ii g' eA d' ie n' u s
lygiagrečiomis	l' ii g' e g' r' e tS' oo m' I s
lygiaverčiai	l' ii g' e v' E R' tS' e j
lyginamas	l' Ii g' i n a m a s
lyginant	l' Ii g' i n a n t
lyginimas	l' Ii g' i n' i m a s
lygio	l' iI g' oo
lygios	l' ii g' oo s
lygis	l' iI g' i s
lygiu	l' ii g' u
lygiui	l' iI g' u j
lygių	l' ii g' uu
lyguma	l' ii g u m A
lygumoje	l' ii g u m oo j' E
lygumą	l' Ii g u m aa
lygus	l' ii g U s
lyriškumas	l' ii r' i S k U m a s
ląstelių	l aa s' t' eA l' uu
ląstelė	l aa s' t' eA l' ee
ląstelėmis	l aa s' t' eA l' ee m' i s
ląstelės	l aa s' t' eA l' ee s
lėktuvo	l' ee k t U v oo
lėmė	l' Ee m' ee
lėtai	l' ee t A J
lūšimis	l Uu S' i m' i s
lūšių	l uu S' uu
lūšys	l Uu S' ii s
lūžių	l uU Z' uu
magistrui	m a g' I s t r u j
magistrų	m a g' I s t r uu
magiški	m aA g' i S' k' i
magiškų	m aA g' i S k uu
maistas	m A J s t a s
maisto	m A J s t oo
maistu	m a j s t U
maitinasi	m a j t' I n a s' i
maitintis	m a j t' I n' t' i s
majų	m aA j' uu
malio	m aA l' oo
maltojo	m Aa l t oo j' oo
mama	m a m A
mamutais	m a m U t a j s
mamutas	m a m U t a s
mamuto	m a m U t oo
mamutu	m a m u t U
mamutų	m a m U t uu
man	m Aa n
mangutų	m a n g u t uu
mano	m A n oo
manoma	m aA n oo m a
manyta	m a n' Ii t a
manyti	m a n' Ii t' i
marija	m a r' i j' E
maršrutų	m a r S r U t uu
mastui	m aA s t u j
masyvi	m a s' ii v' I
masyvūs	m a s' iI v uu s
mat	m A t
matematiką	m a t' e m aA t' i k aa
matematikę	m a t' e m aA t' i k' ea
mato	m aA t oo
matome	m aA t oo m' e
matomu	m aA t oo m u
matuojant	m a t Uo j' e n t
matėsi	m aA t' ee s' i
mažai	m a Z A J
mažame	m a Z a m' E
maždaug	m a Z d A W k
mažesnes	m a Z' e s' n' E s
mažesnis	m a Z' E s' n' i s
mažiau	m a Z' E W
mažiausiai	m a Z' Ea w s' e j
mažiukų	m a Z' U k uu
mažojoje	m a Z oO j' oo j' e
mažosios	m a Z oo s' oo s
mažuose	m a Z uo s' E
mažėja	m a Z' Ee j' e
mažų	m a Z uU
medienos	m' e d' Ie n oo s
medinių	m' e d' I n' uu
medinės	m' e d' I n' ee s
medinę	m' e d' I n' ea
medžiagų	m' eA dZ' e g uu
medžio	m' eA dZ' oo
medžiodami	m' e dZ' Oo d a m' i
medžioja	m' e dZ' Oo j' e
medžioklės	m' e dZ' oO k' l' ee s
medžiot	m' e dZ' Oo t
medžioti	m' e dZ' Oo t' i
medžiotojai	m' e dZ' Oo t oo j' e j
medžiotojų	m' e dZ' Oo t oo j' uu
medžiuose	m' eA dZ' uo s' e
medžių	m' eA dZ' uu
meksikoje	m' E k' s' i k oo j' e
melioracijos	m' e l' o r aA ts' i j' oo s
melodija	m' e l O d' i j' e
melodijas	m' e l O d' i j' e s
melodijos	m' e l O d' i j' oo s
melodijose	m' e l O d' i j' oo s' e
melą	m' eA l aa
membrana	m' e m b r a n A
menininkai	m' eA n' i n' i n k a j
meno	m' eA n oo
menui	m' eA n u j
mergelė	m' e r' g' eA l' ee
mergelės	m' e r' g' eA l' ee s
mes	m' eA s
meta	m' eA t a
metais	m' eA t a j s
meteoras	m' e t' e O r a s
meteorologiniais	m' e t' e o r o l O g' i n' e j s
meteorologinius	m' e t' e o r o l O g' i n' u s
meteorą	m' e t' e O r aa
meto	m' eA t oo
metodika	m' e t O d' i k a
metrai	m' E t r a j
metras	m' E t r a s
metraštyje	m' eA t r a S' t' ii j' e
metro	m' E t r oo
metru	m' e t r U
metrą	m' E t r aa
metrų	m' E t r uu
metu	m' e t U
metus	m' e t U s
metą	m' eA t aa
metų	m' eA t uu
mečetė	m' e tS' E t' ee
mečetės	m' e tS' E t' ee s
mečetę	m' e tS' E t' ea
miestas	m' iE s t a s
mieste	m' ie s' t' E
miestelis	m' ie s' t' eA l' i s
miesto	m' iE s t oo
miestu	m' ie s t U
miestui	m' iE s t u j
miestą	m' iE s t aa
miestų	m' iE s t uu
mikroskopai	m' i k r o s k O p a j
mikroskopo	m' i k r o s k O p oo
mikroskopą	m' i k r o s k O p aa
milijonu	m' i l' i j' oo n U
milijonus	m' i l' i j' oo n U s
milijonų	m' i l' i j' oO n uu
milžiniški	m' I L' Z' i n' i S' k' i
milžiniško	m' I L' Z' i n' i S k oo
milžiniškomis	m' I L' Z' i n' i S k oo m' i s
milžiniškos	m' I L' Z' i n' i S k oo s
milžiniškų	m' I L' Z' i n' i S k uu
mimikos	m' I m' i k oo s
mindaugo	m' I n d a w g oo
mineralinius	m' i n' e r aA l' i n' u s
mineralinių	m' i n' e r aA l' i n' uu
mini	m' I n' i
minimas	m' I n' i m a s
minimi	m' i n' i m' I
ministerijos	m' i n' i s' t' E r' i j' oo s
minta	m' I N t a
minėtas	m' i n' Ee t a s
mirties	m' i r' t' iE s
mirtimi	m' i r' t' i m' I
mirusio	m' I r u s' oo
mirusiųjų	m' I r u s' uu j' uu
mirė	m' I r' ee
mis	m' I s
misijos	m' I s' i j' oo s
mistikos	m' I s' t' i k oo s
mitinės	m' I t' i n' ee s
mitybos	m' i t' Ii b oo s
mitų	m' I t uu
miškatundrėje	m' i S k aA t u n' d' r' ee j' e
miškingose	m' i S' k' I n g oo s' e
miško	m' I S k oo
miškuose	m' i S k uo s' E
miškus	m' i S k U s
miškų	m' i S k uU
mokslininkai	m Oo k' s' l' i n' i n k a j
mokslininkė	m Oo k' s' l' i n' i n' k' ee
mokslininkų	m Oo k' s' l' i n' i n k uu
mokslinius	m Oo k' s' l' i n' u s
mokslą	m Oo k s l aa
mokėjo	m oo k' Ee j' oo
moldovą	m oo l d oo v aa
molinių	m O l' i n' uu
molio	m Oo l' oo
molis	m Oo l' i s
monarcho	m o n Aa r x oo
mongolai	m o n g O l a j
monolitas	m o n o l' I t a s
monumentaliausių	m o n u m' e n t a l' Ea w s' uu
moteris	m Oo t' e r' i s
moters	m Oo t' e r s
moterų	m Oo t' e r uu
mozaikų	m o z Aa j k uu
mozei	m oO z' e j
mumija	m U m' i j' e
muziejus	m u z' iE j' u s
muziejų	m u z' iE j' uu
muzikantai	m u z' i k Aa n t a j
muzikos	m U z' i k oo s
mėginius	m' Ee g' i n' u s
mėginių	m' ee g' i n' uU
mėgo	m' Ee g oo
mėgsta	m' Ee k s t a
mėgstamos	m' Ee k s t a m oo s
mėgstu	m' Ee k s t u
mėgėjai	m' ee g' Ee j' e j
mėnulio	m' ee n U l' oo
mėnulis	m' ee n U l' i s
mėtyti	m' Ee t' ii t' i
mįslė	m' ii s' l' eE
mū	m uu
mūrais	m Uu r a j s
mūras	m Uu r a s
mūrinio	m uu r' I n' oo
mūru	m uu r u
mūrų	m Uu r uu
mūsų	m Uu s uu
mūšyje	m uU S' ii j' e
na	n A
nacionaliniame	n a ts' i o n aA l' i n' e m' e
nacionalinio	n a ts' i o n aA l' i n' oo
nacionaliniuose	n a ts' i o n aA l' i n' uo s' e
nacionalinių	n a ts' i o n aA l' i n' uu
nagais	n a g A J s
naikina	n a j k' I n a
naikino	n a j k' I n oo
naktimis	n a k' t' i m' I s
naktį	n aA k' t' ii
nakčiai	n aA k' tS' e j
namai	n a m A J
namelius	n a m' e l' U s
naminiai	n a m' I n' e j
naminių	n a m' I n' uu
namų	n a m uU
nardant	n Aa r d a n t
nardo	n Aa r d oo
nariai	n a r' E J
narių	n a r' uU
natrio	n aA t' r' oo
natriu	n a t' r' U
natūralių	n a t uu r a l' uU
natūralus	n a t uu r a l U s
naudingi	n a w d' I n' g' i
naudojama	n a w d Oo j' e m a
naudojamas	n a w d Oo j' e m a s
naudojamos	n a w d Oo j' e m oo s
naudojant	n a w d Oo j' e n t
naudojosi	n a w d Oo j' oo s' i
nauja	n a w j' E
naujausius	n a w j' Ea w s' u s
naujieji	n a w j' Ie j' i
naujoji	n a w j' Oo j' i
naujojoje	n a w j' oO j' oo j' e
naujosios	n a w j' oo s' oo s
naujosiose	n a w j' oO s' oo s' e
naujuosius	n a w j' Uo s' u s
naujų	n a w j' uU
našlaičių	n a S l Aa j tS' uu
ne	n' E
neatsisako	n' e a t' s' i s aA k oo
neatskiriama	n' e a t' s' k' i r' e m a
neatskiriami	n' e a t' s' k' i r' e m' I
nebijo	n' e b' I j' oo
nebuvo	n' e b U v oo
nebūdingi	n' e b uu d' I n' g' i
nedaug	n' e d A W k
nedideliu	n' e d' I d' e l' u
nedidelių	n' e d' i d' e l' uU
nedirbamuose	n' e d' i r b a m uo s' E
neegzistuoja	n' e e g' z' i s t Uo j' e
negalinčiam	n' e g aA l' i n' tS' e m
negarios	n' e g a r' oo s
negera	n' e g' e r a
negiliais	n' e g' i l' E J s
negu	n' e g u
nei	n' e j
neigiamo	n' E J g' e m oo
neigiamos	n' E J g' e m oo s
neilgai	n' e j l g a j
neišdildoma	n' e i Z' d' I l d oo m a
neišdildomą	n' e i Z' d' I l d oo m aa
neišranki	n' e i S r a n' k' I
neišsiskiria	n' e i S' s' I s' k' i r' e
neišteka	n' e I S' t' e k a
neištikima	n' e I S' t' i k' i m a
nekerta	n' E k' e r t a
nelengvas	n' e l' E N g v a s
nelimpa	n' e l' I M p a
nemažai	n' e m a Z A J
nemažas	n' e m aA Z a s
nemokėjo	n' e m oo k' Ee j' oo
nemuno	n' eA m u n oo
nemėgsta	n' e m' Ee k s t a
nenaudoja	n' e n a w d Oo j' e
nenaudojo	n' e n a w d Oo j' oo
nenukrypstant	n' e n u k' r' iI p s t a n t
nenuostabu	n' e n uo s t a b U
neolito	n' e o l' I t oo
neolitų	n' e o l' I t uu
nepakanka	n' e p a k A N k a
nepaliestuose	n' e p a l' ie s t uo s' E
nepaliestų	n' e p a l' iE s t uu
nepamiršti	n' e p a m' I R' S' t' i
nepaprastai	n' e p a p r a s t a j
nepaprastame	n' e p a p r a s t a m' E
nepaprasti	n' e p a p r a s' t' i
nepasikeitė	n' e p a s' I k' e j t' ee
nepavojingi	n' e p a v oo j' I n' g' i
nepertraukiama	n' e p' Ea r t r a w k' e m a
nepraktiškas	n' e p r aA k' t' i S k a s
nepralaidžiu	n' e p r a l a j dZ' U
nepraleidžia	n' e p r a l' Ea j dZ' e
nepriekaištingai	n' e p' r' ie k a j S' t' I n g a j
nepritariama	n' e p' r' i t a r' e m a
nepritariame	n' e p' r' I t a r' e m' e
nerandamas	n' e r A N d a m a s
nerandamos	n' e r A N d a m oo s
nerasta	n' e r a s t a
nereguliariai	n' e r' e g u l' e r' E J
nereikia	n' e r' E J k' e
neremontuojama	n' e r' e m o n t Uo j' e m a
neretai	n' e r' e t a j
neries	n' e r' ie s
nes	n' e s
neseniai	n' e s' e n' E J
nesiekia	n' e s' Ie k' e
nesikeitė	n' e s' I k' e j t' ee
nestaugia	n' e s t Aa w g' e
nesuaugusių	n' e s u Aa w g u s' uu
nesunku	n' e s u n k U
nesustabdė	n' e s u s t aA b' d' ee
nesustabdę	n' e s u s t aA b' d' ea
nesuvaržyto	n' e s u v a r' Z' Ii t oo
nesvarbu	n' e s v a r b U
net	n' E t
netinka	n' e t' I N k a
netobuli	n' e t oo b u l' I
netoli	n' e t oo l' I
netrikdo	n' e t' r' I g d oo
netrukus	n' e t r U k u s
neturi	n' e t U r' i
neturėjo	n' e t u r' Ee j' oo
neužšalusiomis	n' e u S S aA l u s' oo m' i s
nevengia	n' e v' Ea n' g' e
nevienpusiai	n' e v' ie n p U s' e j
neįkvėpusi	n' e ii k' v' eE p u s' i
neįmanoma	n' e ii m aA n oo m a
neįveikiama	n' e ii v' e j k' e m a
nešamas	n' eA S a m a s
nešė	n' eA S' ee
nežemiškos	n' e Z' eA m' i S k oo s
nežinia	n' e Z' i n' E
nežino	n' e Z' I n oo
nežinomas	n' e Z' i n oo m a s
nežinomų	n' e Z' i n oo m uu
niekada	n' ie k a d A
niekas	n' iE k a s
nieko	n' iE k oo
niekuomet	n' ie k uo m' E t
niekur	n' iE k u r
nis	n' i s
nišos	n' I S oo s
norint	n oo r' i n t
nors	n oo r s
norvegija	n o r' v' E g' i j' e
norvegijai	n o r' v' E g' i j' e j
norvegijoje	n o r' v' E g' i j' oo j' e
norvegijos	n o r' v' E g' i j' oo s
norvegiją	n o r' v' E g' i j' ea
norėdami	n oo r' Ee d a m' i
nubaido	n u b A J d oo
nublokšti	n u b l oO k' S' t' i
nudilina	n u d' I l' i n a
nudilinę	n u d' I l' i n' ea
nufotografuoti	n u f o t o g r a f Uo t' i
nugriauta	n u g' r' e w t a
nugrimzdo	n u g' r' I M z d oo
nukaršusius	n u k a r S u s' u s
nukeliautų	n u k' e l' Ea w t uu
nukentėjusi	n u k' e n' t' Ee j' u s' i
nukenčia	n u k' E N' tS' e
nuklojo	n u k l Oo j' oo
nukreipta	n u k' r' e j p t a
nukrypus	n u k' r' iI p u s
nukėlė	n u k' Ee l' ee
nukėlę	n u k' Ee l' ea
numatyta	n u m a t' Ii t a
numatytas	n u m a t' Ii t a s
nunykusi	n u n' iI k u s' i
nuo	n uo
nuolat	n uO l a t
nuolatinį	n uo l a t' I n' ii
nuomone	n Uo m oo n' e
nuomonė	n Uo m oo n' ee
nuorodų	n Uo r oo d uu
nuotaiką	n Uo t a j k aa
nuotykių	n Uo t' ii k' uu
nuožulniais	n uo Z u l' n' E J s
nuožulniomis	n uo Z u l' n' oo m' I s
nuplaukti	n u p l A W k' t' i
nuplauti	n u p l Aa w t' i
nurodymu	n u r Oo d' ii m u
nusakoma	n u s aA k oo m a
nusibrėžto	n u s' i b' r' Ee S t oo
nusidriekęs	n u s' i d' r' iE k' ea s
nusikaltėliui	n u s' i k A L' t' ee l' u j
nusileidžia	n u s' i l' Ea j dZ' e
nusileidžianti	n u s' i l' Ea j dZ' e n' t' i
nusimanančio	n u s' i m aA n a n' tS' oo
nusižengimai	n u s' i Z' e n' g' I m a j
nusižiūri	n u s' i Z' uU r' i
nustatyta	n u s t a t' Ii t a
nustatyti	n u s t a t' Ii t' i
nustatė	n u s t aA t' ee
nustelbė	n U s' t' e l' b' ee
nutiesti	n u t' iE s' t' i
nutiestos	n u t' ie s t oo s
nutolusios	n u t oO l u s' oo s
nutraukė	n u t r Aa w k' ee
nutįsęs	n u t' iI s' ea s
nuvalytų	n u v a l' Ii t uu
nuėmimo	n u ee m' I m oo
nykdavo	n' iI g d a v oo
nykimo	n' ii k' I m oo
nyko	n' iI k oo
nykti	n' iI k' t' i
nė	n' ee
nėra	n' ee r A
o	oO
objektas	o b' j' E k t a s
objektu	o b' j' e k t U
observatorija	oo p' s' e r v a t O r' i j' e
ola	oo l A
olos	oo l oO s
olą	oO l aa
olų	oo l uU
orais	oo r A J s
ordino	O r' d' i n oo
ore	oo r' E
organinių	o r g aA n' i n' uu
organizmams	o r g a n' I z m a m s
organizmų	o r g a n' I z m uu
organizuotai	o r g a n' i z Uo t a j
originalumu	o r' i g' i n a l u m U
ornamentika	o r n a m' E N' t' i k a
ornamentuoti	o r n a m' e n t Uo t' i
oro	Oo r oo
ortodoksų	o r t o d O k s uu
ožkos	oo S k oO s
paaiškinimui	p a Aa j S' k' i n' i m u j
paaiškinti	p a Aa j S' k' i n' t' i
pabadavusi	p a b a d aA v u s' i
pabaiga	p a b a j g A
pabaigoje	p a b a j g oo j' E
pabaigos	p a b a j g oO s
pabandė	p a b A N' d' ee
pabrėžė	p a b' r' Ee Z' ee
pabėgusios	p a b' Ee g u s' oo s
padainavus	p a d a j n aA v u s
padainavę	p a d a j n aA v' ea
padalina	p a d a l' I n a
padalytos	p a d a l' Ii t oo s
padaryti	p a d a r' Ii t' i
padavimai	p a d a v' I m a j
padeda	p A d' e d a
padedanti	p A d' e d a n' t' i
padedančių	p A d' e d a n' tS' uu
padengta	p a d' e n k t a
padidina	p a d' I d' i n a
padidės	p a d' i d' eE s
padėti	p a d' Ee t' i
padėtis	p a d' ee t' i s
padėtį	p aA d' ee t' ii
pagal	p a g a l
pagalba	p a g Aa l b a
pagalbos	p a g Aa l b oo s
pagauna	p a g Aa w n a
pagerbdavo	p a g' E R b d a v oo
pagoniškos	p a g Oo n' i S k oo s
pagoniškus	p a g Oo n' i S k u s
pagrindiniai	p a g' r' i n' d' I n' e j
pagrindinis	p a g' r' i n' d' I n' i s
pagrindinius	p a g' r' i n' d' i n' U s
pagrindinių	p a g' r' i n' d' I n' uu
pagrindinėje	p a g' r' i n' d' I n' ee j' e
pagrindinės	p a g' r' i n' d' I n' ee s
pagrindinę	p a g' r' i n' d' I n' ea
pagrindinį	p a g' r' i n' d' I n' ii
pagrindo	p aA g' r' i n d oo
pagrindu	p aA g' r' i n d u
pagyja	p a g' iI j' e
pailgas	p a I l g a s
pajautos	p a j' Ea w t oo s
pajudindavo	p a j' U d' i n d a v oo
pajusti	p a j' U s' t' i
pajėgumai	p a j' ee g U m a j
pajėgų	p a j' ee g uU
pajūrio	p a j' Uu r' oo
pakankamai	p a k A N k a m a j
pakankamo	p a k A N k a m oo
pakartoja	p a k a r t Oo j' e
pakeisti	p a k' E J s' t' i
pakeldavo	p a k' Ea l d a v oo
pakelti	p a k' Ea l' t' i
pakilus	p a k' I l u s
pakrantė	p a k r Aa n' t' ee
pakrantėje	p a k r Aa n' t' ee j' e
pakrantės	p a k r Aa n' t' ee s
pakrantėse	p a k r Aa n' t' ee s' e
pakrančių	p a k r Aa n' tS' uu
pakraštys	p a k r a S' t' iI s
pakraščių	p a k r a S' tS' uU
pakyla	p a k' iI l a
palai	p aA l a j
palaidoti	p a l Aa j d oo t' i
palaiko	p a l a j k oo
palaikus	p aA l a j k u s
palaikyti	p a l a j k' Ii t' i
palaikų	p a l a j k uU
palaipsniui	p a l a j p' s' n' U J
palei	p a l' e j
palikdavo	p a l' I g d a v oo
palikim	p a l' I k' i m
palikimas	p a l' i k' I m a s
palikimu	p a l' i k' i m U
paliks	p a l' I k s
palmių	p Aa l' m' uu
palyginimų	p a l' Ii g' i n' i m uu
palyginti	p a l' Ii g' i n' t' i
pamatais	p a m a t A J s
pamatyti	p a m a t' Ii t' i
pamažu	p a m a Z U
paminklas	p a m' I N k l a s
paminklo	p a m' I N k l oo
paminklų	p a m' I N k l uu
pamokslus	p a m Oo k s l u s
panamos	p a n aA m oo s
panaši	p a n a S' I
panevėžyje	p a n' e v' ee Z' ii j' E
paniro	p a n' I r oo
papildomai	p a p' i l d oo m a j
papildomi	p a p' i l d oo m' i
papildomos	p a p' i l d oo m oo s
paplito	p a p' l' I t oo
paplitusi	p a p' l' I t u s' i
paplitusios	p a p' l' I t u s' oo s
paplitę	p a p' l' I t' ea
paplitęs	p a p' l' I t' ea s
paprastai	p a p r a s t A J
paprastas	p A p r a s t a s
paprastesnis	p a p r a s' t' E s' n' i s
paprastesnės	p a p r a s' t' e s' n' ee s
paprasčiausiai	p a p r a S' tS' Ea w s' e j
papročius	p aA p r oo tS' u s
papuolė	p a p Uo l' ee
papuošta	p a p uo S t a
papuoštais	p a p uo S t A J s
papuoštus	p A p uo S t u s
papėdės	p a p' Ee d' ee s
parazitai	p a r a z' I t a j
pareikalavo	p a r' e j k a l aA v oo
paremti	p a r' E M' t' i
parkas	p Aa r k a s
parke	p Aa r' k' e
parko	p Aa r k oo
parkuose	p Aa r k uo s' e
parkų	p Aa r k uu
parodos	p a r oo d oO s
parodydavo	p a r Oo d' ii d a v oo
parą	p aA r aa
pas	p a s
pasak	p a s a k
pasakoja	p aA s a k oo j' e
pasakojamas	p aA s a k oo j' e m a s
pasakojimas	p aA s a k oo j' i m a s
pasakojimo	p aA s a k oo j' i m oo
pasakyti	p a s a k' Ii t' i
pasakų	p aA s a k uu
pasauli	p a s Aa w l' i
pasaulinis	p a s Aa w l' i n' i s
pasaulio	p a s Aa w l' oo
pasauly	p a s Aa w l' ii
pasaulyje	p a s Aa w l' ii j' e
pasaulį	p a s Aa w l' ii
pasiekiamas	p a s' Ie k' e m a s
pasiekiami	p a s' ie k' e m' I
pasieks	p a s' iE k s
pasiekė	p a s' Ie k' ee
pasikartojantis	p a s' i k a r t Oo j' e n' t' i s
pasikartojančiais	p a s' i k a r t Oo j' e n' tS' e j s
pasikloja	p a s' i k l Oo j' e
pasilikite	p a s' i l' I k' i t' e
pasiliko	p a s' i l' I k oo
pasireikšti	p a s' i r' Ea j k' S' t' i
pasirenka	p a s' I r' e n k a
pasirodyti	p a s' i r Oo d' ii t' i
pasirūpinti	p a s' i r Uu p' i n' t' i
pasislenka	p a s' I s' l' e n k a
pasisotinti	p a s' i s Oo t' i n' t' i
pasitaikius	p a s' i t Aa j k' u s
pasitaiko	p a s' i t Aa j k oo
pasitelkus	p a s' i t' E L k u s
pasiturinčios	p a s' I t u r' i n' tS' oo s
pasižymi	p a s' i Z' iI m' i
pasižyminčios	p a s' i Z' iI m' i n' tS' oo s
paskalbė	p A s k a l' b' ee
paskelbė	p a s' k' Ea l' b' ee
paskirties	p a s' k' i r' t' iE s
paskutinieji	p a s k u t' i n' ie j' i
paskutinioji	p a s k u t' i n' oo j' i
paskutinis	p a s k u t' I n' i s
paskutinį	p a s k u t' I n' ii
paslaptimi	p a s l a p' t' i m' I
paslaptingos	p a s l a p' t' I n g oo s
paslapčių	p a s l a p' tS' uU
paslaugos	p a s l a w g oO s
pasmerktas	p A s' m' e r k t a s
pastaraisiais	p a s t a r A J s' e j s
pastaroji	p a s t a r Oo j' i
pastaruosius	p a s t a r Uo s' u s
pastarąjį	p aA s t a r aa j' ii
pastatai	p a s t a t A J
pastatymui	p a s t aA t' ii m u j
pastatyta	p a s t a t' Ii t a
pastatytas	p a s t a t' Ii t a s
pastatyti	p a s t a t' Ii t' i
pastatytos	p a s t a t' Ii t oo s
pastatytų	p a s t a t' Ii t uu
pastatą	p aA s t a t aa
pastatė	p a s t aA t' ee
pastatų	p a s t a t uU
pastebimai	p a s' t' e b' i m A J
pastebėjo	p a s' t' e b' Ee j' oo
pastebėta	p a s' t' e b' Ee t a
pastebėti	p a s' t' e b' Ee t' i
pastogės	p a s t Oo g' ee s
pastoviai	p a s t oo v' E J
pasveria	p A s' v' e r' e
pasverti	p a s' v' E R' t' i
pasvirusiais	p a s' v' I r u s' e j s
pasvėrė	p A s' v' ee r' ee
pat	p A t
patalpas	p aA t a l p a s
patalpoje	p a t a l p oo j' E
patarimai	p a t a r' I m a j
patarlių	p a t a r' l' uU
patarme	p aA t a r' m' e
pateka	p aA t' e k a
patekimui	p a t' e k' I m u j
patekimą	p a t' e k' I m aa
pateko	p a t' eA k oo
patekti	p a t' E k' t' i
pati	p a t' I
paties	p a t' iE s
patiklūs	p a t' I k l uu s
pats	p A t s
patvarūs	p a t v aA r uu s
patvirtina	p a t' v' I r' t' i n a
patyręs	p a t' Ii r' ea s
patęs	p a t' eA s
patęsti	p a t' eA s' t' i
paukščiai	p A W k' S' tS' e j
paukščiu	p a w k' S' tS' U
paukščius	p a w k' S' tS' U s
paukščių	p A W k' S' tS' uu
pauze	p Aa w z' e
pauzė	p Aa w z' ee
pavadinimas	p a v a d' I n' i m a s
pavadinimo	p a v a d' I n' i m oo
pavadinimu	p a v a d' I n' i m u
pavadinimą	p a v a d' I n' i m aa
pavadinimų	p a v a d' I n' i m uu
pavadino	p a v a d' I n oo
pavadintas	p a v a d' I n t a s
pavadintos	p a v a d' I n t oo s
pavakary	p a v a k a r' iI
pavardę	p aA v a r' d' ea
pavasarį	p a v aA s a r' ii
paveldu	p aA v' e l d u
paversta	p a v' e r s t a
pavidalo	p a v' I d a l oo
pavieniui	p a v' ie n' U J
pavieniuose	p a v' iE n' uo s' e
pavienių	p a v' iE n' uu
paviršiaus	p a v' I R' S' e w s
paviršinio	p a v' I R' S' i n' oo
paviršius	p a v' I R' S' u s
paviršių	p a v' I R' S' uu
pavojų	p a v oO j' uu
pavyzdžiai	p a v' ii Z' dZ' E J
pavyzdžiui	p aA v' ii Z' dZ' u j
pavėlavęs	p a v' ee l aA v' ea s
pačiais	p a tS' E J s
pačias	p a tS' E s
pačios	p a tS' oo s
pačiu	p a tS' U
pašaukta	p a S a w k t a
pažemėjo	p a Z' e m' Ee j' oo
pažvelgus	p a Z' v' E L g u s
pažymima	p a Z' iI m' i m a
pažymėti	p a Z' ii m' Ee t' i
pele	p' e l' E
peleko	p' eA l' e k oo
pelenai	p' e l' e n A J
pelenų	p' e l' e n uU
peles	p' e l' E s
pelėmis	p' e l' ee m' I s
pelėnais	p' e l' Ee n a j s
pelės	p' e l' ee s
penki	p' e n' k' I
penkiasdešimt	p' E N' k' e z' d' e S' i m t
penkiasdešimties	p' E N' k' e z' d' e S' i m' t' ie s
penkiolika	p' e n' k' Oo l' i k a
penkiolikto	p' e n' k' Oo l' i k t oo
penkioliktuosius	p' e n' k' Oo l' i k t uo s' u s
penkis	p' e n' k' I s
penkių	p' e n' k' uU
penktadalis	p' e n k t aA d a l' i s
penkto	p' E N k t oo
penktoji	p' e n k t Oo j' i
per	p' e r
perdavimui	p' Ea r d a v' i m u j
perduodavo	p' Ea r d uo d a v oo
perduoti	p' Ea r d uo t' i
pereina	p' Ea r' e j n a
periodiškumą	p' e r' i o d' i S k U m aa
periodui	p' e r' i O d u j
perkeldavo	p' Ea r' k' e l d a v oo
perkūno	p' e r k Uu n oo
pernešė	p' Ea r' n' e S' ee
pernešę	p' Ea r' n' e S' ea
personažai	p' e r s o n aA Z a j
personažais	p' e r s o n aA Z a j s
perspėja	p' Ea r' s' p' ee j' e
perstatyta	p' Ea r s t a t' ii t a
perteklius	p' E R' t' e k' l' u s
peru	p' e r U
perėjose	p' Ea r' ee j' oo s' e
peršalau	p' Ea r S a l a w
pieta	p' ie t a
pietine	p' ie t' i n' E
pietinė	p' ie t' I n' ee
pietinėje	p' ie t' I n' ee j' e
pietrytinėje	p' ie t' r' ii t' I n' ee j' e
pietus	p' ie t U s
pietų	p' ie t uU
pievose	p' Ie v oo s' e
pieši	p' ie S' i
piešiniai	p' ie S' i n' E J
piešiniais	p' ie S' i n' E J s
piešiniu	p' iE S' i n' u
piešinius	p' iE S' i n' u s
piešinių	p' ie S' i n' uU
piešti	p' iE S' t' i
piktogramomis	p' i k t o g r aA m oo m' i s
piliakalniai	p' I l' e k a l' n' e j
piliakalniais	p' I l' e k a l' n' e j s
piliakalnio	p' I l' e k a l' n' oo
piliakalniuose	p' I l' e k a l' n' uo s' e
piliakalnių	p' I l' e k a l' n' uu
pilies	p' i l' iE s
pilietinę	p' i l' iE t' i n' ea
pilimi	p' i l' i m' I
pilis	p' i l' I s
pilių	p' i l' uU
pilkasis	p' i l k A s' i s
pilkos	p' i l k oo s
pilkąjį	p' I l k aa j' ii
pilniu	p' i l' n' U
pilyje	p' i l' ii j' E
pilys	p' I l' ii s
pingvinu	p' i n' g' v' i n U
piramides	p' i r a m' i d' E s
piramidė	p' i r a m' I d' ee
piramidėje	p' i r a m' I d' ee j' e
piramidės	p' i r a m' I d' ee s
piramidę	p' i r a m' I d' ea
piramidžių	p' i r a m' I dZ' uu
pirkiniams	p' i r' k' i n' Ea m s
pirmasis	p' i r m A s' i s
pirmiausia	p' i r' m' Ea w s' e
pirmiausiai	p' i r' m' Ea w s' e j
pirmieji	p' i r' m' Ie j' i
pirminei	p' i r' m' I n' e j
pirmoje	p' i r m oo j' E
pirmoji	p' i r m Oo j' i
pirmojo	p' I r m oo j' oo
pirmojoje	p' i r m oO j' oo j' e
pirmosios	p' i r m oO s' oo s
pirmykščiai	p' i r' m' Ii k' S' tS' e j
pirmą	p' I r m aa
pirmąją	p' I r m aa j' ea
pirmųjų	p' i r m uU j' uu
pirštai	p' I R S t a j
pjaunant	p' j' Ea w n a n t
planetoje	p l a n' E t oo j' e
planetų	p l a n' E t uu
platesnis	p l a t' E s' n' i s
plati	p l a t' I
platumų	p l a t u m uu
plaukeliais	p l a w k' eA l' e j s
plaukia	p l A W k' e
plauko	p l a w k oo
plaukusiam	p l A W k u s' e m
plaustų	p l A W s t uu
plazminė	p l aA z' m' i n' ee
plačiai	p l a tS' E J
plačiau	p l a tS' E W
plačiausiu	p l a tS' Ea w s' u
plačios	p l a tS' oo s
plika	p' l' i k a
plokštelėmis	p l oo k' S' t' eA l' ee m' i s
plokšti	p l Oo k' S' t' i
plokštumomis	p l oo k S t u m oo m' i s
plokštumų	p l oo k S t U m uu
plot	p l Oo t
plota	p l oo t a
plotai	p l Oo t a j
plotas	p l Oo t a s
plote	p l Oo t' e
plotis	p l oo t' i s
ploto	p l Oo t oo
plotuose	p l Oo t uo s' e
plotą	p l Oo t aa
pločio	p l oO tS' oo
plytinės	p' l' iI t' i n' ee s
plytomis	p' l' iI t oo m' i s
plytų	p' l' iI t uu
plėtrą	p' l' eE t r aa
plėšikaujančių	p' l' ee S' i k Aa w j' e n' tS' uu
plėšrieji	p' l' ee S' r' Ie j' i
plėšrus	p' l' ee S r U s
plėšrūnai	p' l' ee S r uU n a j
plėšrūnais	p' l' ee S r uU n a j s
plūkto	p l uU k t oo
plūsti	p l Uu s' t' i
po	p oo
pokario	p Oo k a r' oo
polifonijai	p o l' i f O n' i j' e j
polifonijos	p o l' i f O n' i j' oo s
polis	p oO l' i s
politiniai	p o l' I t' i n' e j
politinis	p o l' I t' i n' i s
politinių	p o l' I t' i n' uu
polonizuot	p o l o n' i z Uo t
polonizuota	p o l o n' i z Uo t a
pomirtinę	p oo m' i r' t' I n' ea
pomirtinį	p oo m' i r' t' I n' ii
populiacijai	p o p u l' eA ts' i j' e j
populiarėjančios	p o p u l' e r' Ee j' e n' tS' oo s
pora	p oo r A
porai	p Oo r a j
poros	p oo r oO s
portalus	p o r t a l U s
porą	p Oo r aa
porūšiai	p Oo r uu S' e j
porūšių	p Oo r uu S' uu
posakių	p Oo s a k' uu
posmelį	p oo s' m' eA l' ii
požeminiai	p oo Z' e m' I n' e j
požeminio	p oo Z' e m' I n' oo
požeminis	p oo Z' e m' I n' i s
požeminių	p oo Z' e m' I n' uu
požeminė	p oo Z' e m' I n' ee
požiūris	p Oo Z' uu r' i s
požiūrį	p Oo Z' uu r' ii
prabėgusiais	p r a b' Ee g u s' e j s
pradėjo	p r a d' Ee j' oo
pradėjus	p r a d' Ee j' u s
pradėtas	p r a d' Ee t a s
pradėti	p r a d' Ee t' i
pradėtos	p r a d' ee t oo s
pradžioje	p r a dZ' oo j' E
pradžios	p r a dZ' oO s
pradžių	p r a dZ' uU
praeityje	p r a e j t' ii j' E
prakaito	p r a k a j t oo
praktiškai	p r aA k' t' i S k a j
pranašui	p r aA n a S u j
prapuolė	p r a p Uo l' ee
prarado	p r a r aA d oo
prasideda	p r a s' I d' e d a
prasidėjo	p r a s' i d' Ee j' oo
pratęsti	p r a t' eA s' t' i
pravardę	p r aA v a r' d' ea
praėjimai	p r a ee j' I m a j
praėjimų	p r a ee j' I m uu
prašau	p r a S A W
prašoma	p r aA S oo m a
prekybiniais	p' r' e k' Ii b' i n' e j s
prekybos	p' r' e k' Ii b oo s
prie	p' r' ie
prieblandą	p' r' Ie b l a n d aa
priedainių	p' r' Ie d a j n' uu
priegaidė	p' r' Ie g a j d' ee
priegaidės	p' r' Ie g a j d' ee s
prieglobsčiu	p' r' Ie g l oo p' S' tS' u
prieglobsčių	p' r' Ie g l oo p' S' tS' uu
prieinamose	p' r' i e j n a m oo s' E
priekio	p' r' Ie k' oo
prietaisais	p' r' Ie t a j s a j s
prietaisų	p' r' Ie t a j s uu
prieš	p' r' iE S
priešai	p' r' Ie S a j
priešas	p' r' Ie S a s
priešistorinės	p' r' ie S' i s t O r' i n' ee s
priešistorės	p' r' Ie S' i s t oo r' ee s
priešiški	p' r' Ie S' i S' k' i
priešpilniu	p' r' Ie S' p' i l' n' u
priešų	p' r' Ie S uu
priežasties	p' r' ie Z a s' t' iE s
priežastys	p' r' Ie Z a s' t' ii s
priežasčių	p' r' ie Z a S' tS' uU
prijungta	p' r' i j' u n k t a
priklausanti	p' r' i k l A W s a n' t' i
priklausantis	p' r' i k l A W s a n' t' i s
priklausančios	p' r' i k l A W s a n' tS' oo s
priklauso	p' r' i k l A W s oo
priklausomai	p' r' i k l A W s oo m a j
priklausomi	p' r' i k l A W s oo m' i
primityvių	p' r' i m' i t' ii v' uU
princesėms	p' r' i n' ts' E s' ee m s
principas	p' r' I n' ts' i p a s
principu	p' r' I n' ts' i p u
pripažino	p' r' i p a Z' I n oo
pripildę	p' r' i p' I l' d' ea
prisidėjo	p' r' i s' i d' Ee j' oo
prisilietimo	p' r' i s' i l' ie t' I m oo
prisitaikę	p' r' i s' i t Aa j k' ea
priskaičiuojama	p' r' i s k a j tS' Uo j' e m a
priskaičiuota	p' r' i s k a j tS' Uo t a
priskiriamos	p' r' I s' k' i r' e m oo s
priskiriantys	p' r' I s' k' i r' e n' t' ii s
priskirti	p' r' i s' k' I r' t' i
pritaikyta	p' r' i t Aa j k' ii t a
privačia	p' r' i v a tS' E
priėmimu	p' r' i ee m' i m U
priėmė	p' r' I ee m' ee
pro	p r oo
procentų	p r O ts' e n t uu
proceso	p r o ts' E s oo
procesu	p r o ts' e s U
procesus	p r o ts' e s U s
procesą	p r o ts' E s aa
produkto	p r o d U k t oo
produktu	p r o d u k t U
produktų	p r o d U k t uu
profesorius	p r o f' E s o r' u s
progai	p r Oo g a j
progos	p r Oo g oo s
properšomis	p r Oo p' e r S oo m' i s
proporcingo	p r o p o r' ts' I n g oo
protingoms	p r oo t' I n g oo m s
protingos	p r oo t' I n g oo s
protėvis	p r Oo t' ee v' i s
provincija	p r o v' I n' ts' i j' e
puikiai	p U J k' e j
pulti	p U l' t' i
pumomis	p U m oo m' i s
puola	p Uo l a
puolančiųjų	p Uo l a n' tS' uu j' uu
puošiančios	p uO S' e n' tS' oo s
puošti	p uO S' t' i
pusantro	p u s A N t r oo
puse	p u s' E
pusiaujo	p u s' Ea w j' oo
pusių	p U s' uu
pusrutulyje	p U s r u t u l' ii j' e
pustrečių	p u s' t' r' e tS' uU
pusėje	p U s' ee j' e
puvo	p U v oo
pučia	p U tS' e
pušynai	p u S' Ii n a j
pėdas	p' Ee d a s
pėdose	p' ee d oo s' E
pėdsakų	p' Ee t s a k uu
pėdų	p' ee d uU
pūsti	p uU s' t' i
raganosiai	r a g a n oO s' e j
raginėmis	r a g' I n' ee m' i s
raibuliuojantį	r a j b u l' Uo j' e n' t' ii
raidą	r A J d aa
raiteliai	r A J t' e l' e j
raiteliais	r A J t' e l' e j s
raižyba	r a j Z' Ii b a
rajono	r a j' O n oo
rajonuose	r a j' O n uo s' e
ramiuose	r a m' uo s' e
rampos	r Aa m p oo s
ramybe	r a m' Ii b' e
randama	r a n d a m a
randamos	r A N d a m oo s
ranka	r a n k a
rankraščių	r A N k r a S' tS' uu
ras	r A s
rasta	r a s t a
rastas	r aA s t a s
rasti	r A s' t' i
rastos	r a s t oo s
ratais	r aA t a j s
ratas	r aA t a s
rato	r aA t oo
raudonąją	r a w d Oo n aa j' ea
rašoma	r aA S oo m a
rašome	r aA S oo m' e
raštai	r aA S t a j
rašytiniuose	r a S' Ii t' i n' uo s' e
rašė	r a S' ee
reformacijai	r' e f o r m aA ts' i j' e j
reginys	r' e g' i n' iI s
regionas	r' e g' i O n a s
regione	r' e g' i o n' E
regioniniai	r' e g' i O n' i n' e j
regioną	r' e g' i O n aa
regionų	r' e g' i O n uu
regis	r' eA g' i s
reguliuoja	r' e g u l' Uo j' e
reguliuoti	r' e g u l' Uo t' i
regą	r' eA g aa
reikalaujama	r' e j k a l Aa w j' e m a
reikalingas	r' e j k a l' I n g a s
reikalų	r' e j k a l uU
reikia	r' E J k' e
reikėtų	r' e j k' Ee t uu
reikš	r' E J k S
reikšme	r' Ea j k' S' m' e
reikšmingiausių	r' e j k' S' m' i n' g' Ea w s' uu
reikšmės	r' e j k' S' m' ee s
reikšmę	r' Ea j k' S' m' ea
reiškia	r' Ea j S' k' e
reiškinio	r' Ea j S' k' i n' oo
reiškiniui	r' Ea j S' k' i n' u j
reiškinys	r' e j S' k' i n' iI s
reiškė	r' Ea j S' k' ee
religiniai	r' e l' I g' i n' e j
religinis	r' e l' I g' i n' i s
religinė	r' e l' I g' i n' ee
relikvijų	r' e l' I k' v' i j' uu
reljefais	r' e l' j' E f a j s
reljefo	r' e l' j' E f oo
remontas	r' e m O n t a s
rengdavo	r' E N g d a v oo
rengiami	r' e n' g' e m' I
renginys	r' e n' g' i n' iI s
renka	r' E N k a
renkami	r' e n k a m' I
respublikoje	r' e s p U b' l' i k oo j' e
respublikos	r' e s p U b' l' i k oo s
restauruoti	r' e s t a w r Uo t' i
retesnis	r' e t' E s' n' i s
retos	r' e t oo s
retus	r' e t U s
retų	r' e t uU
rezervatuose	r' e z' e r v aA t uo s' e
ribas	r' i b A s
riestais	r' ie s t A J s
rifai	r' I f a j
rimtais	r' i m t A J s
ritmas	r' I t m a s
ritmikai	r' I t' m' i k a j
ritualines	r' i t u aA l' i n' e s
ritualus	r' i t u a l U s
ritulį	r' I t u l' ii
rodantis	r Oo d a n' t' i s
rodo	r Oo d oo
rogių	r oO g' uu
romos	r O m oo s
roplių	r oo p' l' uU
rumunų	r u m U n uu
ruonių	r Uo n' uu
ruožas	r Uo Z a s
ruožus	r Uo Z u s
rusija	r U s' i j' e
rusijoje	r U s' i j' oo j' e
rusijos	r U s' i j' oo s
rusų	r U s uu
rutulį	r U t u l' ii
rytinėje	r' ii t' I n' ee j' e
rytus	r' Ii t u s
rytą	r' Ii t aa
rytų	r' ii t uU
ryšius	r' ii S' U s
ryškiausios	r' ii S' k' Ea w s' oo s
rėminę	r' Ee m' i n' ea
rėmė	r' eE m' ee
rūmai	r Uu m a j
rūmas	r Uu m a s
rūmus	r Uu m u s
rūsys	r uu s' iI s
rūšimi	r Uu S' i m' i
rūšims	r Uu S' i m s
rūšis	r Uu S' i s
rūšių	r Uu S' uu
rūšys	r Uu S' ii s
s	E s
sa	s a
sacharoje	s a x a r oo j' e
sako	s aA k oo
sakrali	s a k r a l' i
sakralinio	s a k r aA l' i n' oo
sakralinė	s a k r aA l' i n' ee
sakydavęs	s a k' Ii d a v' ea s
salas	s aA l a s
saldainiu	s a l d a j n' U
saldainių	s a l d A J n' uu
saldumynų	s a l d u m' Ii n uu
salių	s aA l' uu
saloje	s a l oo j' E
saloms	s a l Oo m s
salos	s a l oO s
salose	s a l oo s' E
salų	s a l uU
sampratą	s Aa m p r a t aa
san	s A n
sandėliu	s Aa n' d' ee l' u
sandėlių	s Aa n' d' ee l' uu
sanitarais	s a n' i t aA r a j s
santykiai	s Aa n' t' ii k' e j
santykiais	s Aa n' t' ii k' e j s
santykis	s Aa n' t' ii k' i s
sapnus	s a p n U s
sargybos	s a r' g' Ii b oo s
sau	s Aa w
saugių	s a w g' uU
saugo	s a w g oo
saugoma	s Aa w g oo m a
saugoti	s Aa w g oo t' i
saugumo	s a w g U m oo
saule	s Aa w l' e
saules	s Aa w l' e s
saulutės	s a w l U t' ee s
saulė	s Aa w l' ee
saulėgrąžą	s a w l' Ee g r aa Z aa
saulėgrąžų	s a w l' Ee g r aa Z uu
saulėgrįžą	s a w l' Ee g' r' ii Z aa
saulėgrįžų	s a w l' Ee g' r' ii Z uu
saulėje	s Aa w l' ee j' e
saulės	s Aa w l' ee s
saus	s A W s
sausi	s a w s' I
sausos	s a w s oo s
sausra	s a w s r A
sausras	s a w s r A s
sausringose	s a w s' r' I n g oo s' e
sausros	s a w s r oO s
sausuma	s a w s u m A
sausumoje	s a w s u m oo j' E
sausumos	s a w s u m oO s
savarankiškai	s a v a r A N' k' i S k a j
savarankiškų	s a v a r A N' k' i S k uu
save	s a v' E
savimi	s a v' i m' I
savitumą	s a v' i t U m aa
savivaldybės	s a v' i v a l' d' Ii b' ee s
savo	s A v oo
savosios	s a v oO s' oo s
savotiška	s a v Oo t' i S k a
savybių	s a v' Ii b' uu
seisminėje	s' e j s' m' I n' ee j' e
seisminėse	s' e j s' m' I n' ee s' e
seklesniame	s' e k' l' e s' n' e m' E
sekretoriato	s' e k' r' e t oo r' i aA t oo
sekundžių	s' e k U n' dZ' uu
sena	s' e n a
senais	s' e n A J s
senasis	s' e n A s' i s
seni	s' e n' I
seniai	s' e n' E J
seniau	s' e n' E W
seniausiais	s' e n' Ea w s' e j s
seniausias	s' e n' Ea w s' e s
seniausios	s' e n' Ea w s' oo s
seniausių	s' e n' Ea w s' uu
seno	s' eA n oo
senoji	s' e n Oo j' i
senojo	s' eA n oo j' oo
senojoje	s' e n oO j' oo j' e
senolis	s' e n oO l' i s
senovines	s' e n Oo v' i n' e s
senovinis	s' e n Oo v' i n' i s
senovėje	s' e n Oo v' ee j' e
senovės	s' e n Oo v' ee s
seną	s' eA n aa
senųjų	s' e n uU j' uu
septintaisiais	s' e p' t' i n t A J s' e j s
septintame	s' e p' t' i n t a m' E
septintojo	s' e p' t' I N t oo j' oo
septyni	s' e p' t' ii n' I
septyniasdešimt	s' e p' t' Ii n' e z' d' e S' i m t
septyniolika	s' e p' t' ii n' Oo l' i k a
septynioliktajame	s' e p' t' ii n' Oo l' i k t a j' e m' e
septynioliktame	s' e p' t' ii n' Oo l' i k t a m' e
septyniolikto	s' e p' t' ii n' Oo l' i k t oo
septynioliktojo	s' e p' t' ii n' Oo l' i k t oo j' oo
septynis	s' e p' t' Ii n' i s
septynių	s' e p' t' ii n' uU
serbų	s' E R b uu
siauras	s' E W r a s
siauros	s' e w r oo s
siaurų	s' e w r uU
sibiro	s' I b' i r oo
sidabriniais	s' i d a b' r' I n' e j s
sidabrinėmis	s' i d a b' r' I n' ee m' i s
sieja	s' Ie j' e
siekia	s' Ie k' e
siekiant	s' Ie k' e n t
siekti	s' Ie k' t' i
siekė	s' Ie k' ee
sieliu	s' Ie l' u
sielių	s' Ie l' uu
sielą	s' Ie l aa
siena	s' Ie n a
sienas	s' Ie n a s
sienele	s' ie n' e l' E
sienelė	s' ie n' eA l' ee
sienelę	s' ie n' eA l' ea
sienoje	s' Ie n oo j' e
sienos	s' Ie n oo s
sieną	s' Ie n aa
sienų	s' Ie n uu
sieti	s' Ie t' i
signalais	s' i g n aA l a j s
signalas	s' i g n aA l a s
signalinio	s' i g n aA l' i n' oo
signalinių	s' i g n aA l' i n' uu
signalo	s' i g n aA l oo
sija	s' i j' E
sijos	s' i j' oO s
simbolis	s' I M b o l' i s
sintezė	s' I N' t' e z' ee
sistema	s' i s' t' e m A
sistemoje	s' i s' t' E m oo j' e
siužetuose	s' u Z' E t uo s' e
siužetų	s' u Z' E t uu
siūloma	s' Uu l oo m a
skaidomas	s k Aa j d oo m a s
skaičius	s k A J tS' u s
skalbiamoji	s k a l' b' e m Oo j' i
skamba	s k A M b a
skauda	s k A W d a
skaudžią	s k A W dZ' ea
skaus	s k A W s
skausmo	s k A W s m oo
skeldėjo	s' k' Ea l' d' ee j' oo
skersinė	s' k' e r' s' I n' ee
skersmens	s' k' e r' s' m' E N s
skiriamas	s' k' I r' e m a s
skiriamasis	s' k' i r' e m A s' i s
skiriasi	s' k' I r' e s' i
skirta	s' k' i r t a
skirti	s' k' I r' t' i
skirtingas	s' k' i r' t' I n g a s
skirtingo	s' k' i r' t' I n g oo
skirtingu	s' k' i r' t' I n g u
skirtingus	s' k' i r' t' I n g u s
skirtingų	s' k' i r' t' I n g uu
skirto	s' k' I r t oo
skirtumai	s' k' I r t u m a j
skirtumas	s' k' I r t u m a s
skirtą	s' k' I r t aa
skituose	s' k' I t uo s' e
skleidžiamas	s' k' l' E J dZ' e m a s
skobtos	s k oo p t oo s
skrodžia	s k r Oo dZ' e
skubėti	s k u b' Ee t' i
skulptūrinių	s k u l p t uU r' i n' uu
skulptūros	s k u l p t uU r oo s
skydai	s' k' ii d a j
skyriuje	s' k' iI r' u j' e
skyrius	s' k' iI r' u s
skystas	s' k' Ii s t a s
slegiamas	s' l' eA g' e m a s
slenksčius	s' l' e n' k' S' tS' U s
sliekus	s' l' Ie k u s
sloguoju	s l oo g Uo j' u
sluoksniais	s l Uo k' s' n' e j s
sluoksnis	s l Uo k' s' n' i s
sluoksnyje	s l Uo k' s' n' ii j' e
slėgiu	s' l' ee g' U
slėgiui	s' l' eE g' u j
slėnio	s' l' eE n' oo
slėnis	s' l' eE n' i s
slėniuose	s' l' ee n' uo s' e
slėnius	s' l' ee n' U s
slėnyje	s' l' eE n' ii j' e
slėptuvių	s' l' ee p t U v' uu
slūgsantis	s l uU k s a n' t' i s
smarkiai	s m A R' k' e j
smiltainio	s' m' i l t A J n' oo
smulkaus	s m u l k A W s
smulkius	s m U l' k' u s
smulkus	s m u l k U s
smėlio	s' m' eE l' oo
smėlis	s' m' eE l' i s
smėlynų	s' m' ee l' Ii n uu
smūgių	s m uU g' uu
snapo	s n aA p oo
sniegas	s' n' iE g a s
soda	s o d A
sodybose	s oo d' Ii b oo s' e
sos	s oo s
sostine	s Oo s' t' i n' e
sostinė	s Oo s' t' i n' ee
sostinę	s Oo s' t' i n' ea
sostą	s Oo s t aa
spalvingas	s p a l' v' I n g a s
spalvingieji	s p a l' v' I n' g' ie j' i
spalvos	s p a l v oO s
spartinamu	s p A R' t' i n a m u
sparčiai	s p A R' tS' e j
sparčiau	s p a r' tS' E W
specialius	s' p' e ts' i a l' U s
specializuoti	s' p' e ts' i a l' i z Uo t' i
specialių	s' p' e ts' i a l' uU
specialus	s' p' e ts' i a l U s
specifinės	s' p' e ts' I f' i n' ee s
spektakli	s' p' e k t aA k' l' i
spektakliai	s' p' e k t aA k' l' e j
spinduliu	s' p' I N d u l' u
spiralės	s' p' i r aA l' ee s
sporto	s p O r t oo
sportuoju	s p o r t Uo j' u
sportuoti	s p o r t Uo t' i
sprendžiami	s' p' r' e n' dZ' e m' I
spygliai	s' p' ii g' l' E J
spąstuose	s p Aa s t uo s' e
spąstus	s p Aa s t u s
sraunius	s r a w n' U s
sraunių	s r a w n' uU
srautai	s r A W t a j
sritis	s' r' i t' I s
sritį	s' r' I t' ii
sričių	s' r' i tS' uU
srovė	s r oo v' eE
srovę	s r oO v' ea
stabai	s t a b A J
staiga	s t a j g A
stalinė	s t a l' I n' ee
stalų	s t a l uU
stambesnis	s t a m' b' E s' n' i s
stambiais	s t a m' b' E J s
stambiausias	s t a m' b' Ea w s' e s
startinės	s t Aa r' t' i n' ee s
startinę	s t Aa r' t' i n' ea
statant	s t aA t a n t
statiniai	s t a t' i n' E J
statinys	s t a t' i n' iI s
stato	s t aA t oo
statomas	s t aA t oo m a s
statomi	s t aA t oo m' i
statomos	s t aA t oo m oo s
statyba	s t a t' Ii b a
statybinių	s t a t' Ii b' i n' uu
statyboms	s t a t' Ii b oo m s
statybos	s t a t' Ii b oo s
statybviečių	s t a t' ii b' v' ie tS' uu
statydami	s t a t' Ii d a m' i
statymo	s t aA t' ii m oo
statytas	s t a t' Ii t a s
statyti	s t a t' Ii t' i
statytis	s t a t' Ii t' i s
statė	s t aA t' ee
statų	s t a t uU
staugiama	s t a w g' e m a
staugimas	s t a w g' I m a s
stačiakampio	s t a tS' eA k a m' p' oo
stačiomis	s t a tS' oo m' I s
stačiąja	s t a tS' Ea j' e
stačiąją	s t aA tS' ea j' ea
stačių	s t a tS' uU
stebi	s' t' eA b' i
stebima	s' t' eA b' i m a
stebimi	s' t' e b' i m' I
stebina	s' t' eA b' i n a
stebino	s' t' eA b' i n oo
stebint	s' t' eA b' i n t
stebuklo	s' t' e b U k l oo
stebėjimai	s' t' e b' Ee j' i m a j
stebėjimo	s' t' e b' Ee j' i m oo
stebėti	s' t' e b' Ee t' i
stengiasi	s' t' Ea n' g' e s' i
stengėsi	s' t' Ea n' g' ee s' i
stepių	s' t' E p' uu
stiklas	s' t' I k l a s
stiliuose	s' t' I l' uo s' e
stilius	s' t' I l' u s
stilizuota	s' t' i l' i z Uo t a
stilizuotų	s' t' i l' i z Uo t uu
stiprumo	s' t' i p r U m oo
stipruoliai	s' t' i p r uO l' e j
stiprus	s' t' i p r U s
stiprėti	s' t' i p' r' Ee t' i
stiprūs	s' t' I p r uu s
stokos	s t oo k oO s
storio	s t oO r' oo
storus	s t Oo r u s
stouhendžo	s t oo w h' e n dZ oo
stouhendžui	s t oo w h' e n dZ u j
stouhendžą	s t oo w h' e n dZ aa
stounhedžui	s t oo w n' h' e dZ u j
stounhendžo	s t oo w n' h' e n dZ oo
stounhendžui	s t oo w n' h' e n dZ u j
stounhendžą	s t oo w n' h' e n dZ aa
stovi	s t Oo v' i
stovyklavietės	s t oo v' ii k l aA v' ie t' ee s
stovėjo	s t oo v' Ee j' oo
straipsniai	s t r Aa j p' s' n' e j
strateginę	s t r a t' E g' i n' ea
struktūrinis	s t r u k t uU r' i n' i s
struktūros	s t r u k t uU r oo s
studijavo	s t u d' i j' eA v oo
stulpų	s t u l p uU
stūkso	s t uU k s oo
su	s u
suakmenėjusiu	s u a k' m' e n' Ee j' u s' u
suakmenėjusių	s u a k' m' e n' Ee j' u s' uu
suakmenėjusį	s u a k' m' e n' Ee j' u s' ii
suartėjimui	s u a r' t' Ee j' i m u j
suaugusio	s u Aa w g u s' oo
suaugusių	s u Aa w g u s' uu
suaugusiųjų	s u Aa w g u s' uu j' uu
suaugę	s u Aa w g' ea
subrendusių	s u b' r' Ea n d u s' uu
subtilūs	s u p' t' I l uu s
sudaro	s u d aA r oo
sudarydavo	s u d a r' Ii d a v oo
sudarymas	s u d aA r' ii m a s
sudarymo	s u d aA r' ii m oo
sudarytas	s u d a r' Ii t a s
sudaryti	s u d a r' Ii t' i
sudarytos	s u d a r' Ii t oo s
sudarė	s u d aA r' ee
sudegintas	s u d' eA g' i n t a s
sudomino	s u d oO m' i n oo
sudėjimo	s u d' ee j' I m oo
sudėtinga	s u d' ee t' I n g a
sudėtingas	s u d' ee t' I n g a s
sudėtingi	s u d' ee t' I n' g' i
suformuodamas	s u f o r m Uo d a m a s
suformuotas	s u f o r m Uo t a s
sugalvojo	s u g a l v Oo j' oo
sugalvoti	s u g a l v Oo t' i
suglumo	s u g l U m oo
sugriauta	s u g' r' e w t a
sugriautas	s u g' r' Ea w t a s
sugriautos	s u g' r' e w t oo s
sugriovė	s u g' r' Oo v' ee
sugriuvo	s u g' r' U v oo
sugyvenimo	s u g' ii v' eA n' i m oo
sujungti	s u j' U n' k' t' i
sujungtos	s u j' u n k t oo s
sukasi	s U k a s' i
sukelia	s U k' e l' e
sukilo	s u k' I l oo
suklestint	s U k' l' e s' t' i n t
suklestėjo	s u k' l' e s' t' Ee j' oo
sukurta	s u k u r t a
sukurtas	s u k U r t a s
sukurti	s u k U r' t' i
sukurtu	s u k U r t u
sukėlė	s u k' Ee l' ee
sumažėjo	s u m a Z' Ee j' oo
sumedėjusiais	s u m' e d' Ee j' u s' e j s
sumokėt	s u m oo k' ee t
sumokėti	s u m oo k' Ee t' i
sumūrytos	s u m Uu r' ii t oo s
sunaikina	s u n a j k' I n a
sunerimę	s u n' e r' I m' ea
sunkiai	s U N' k' e j
sunku	s u n k U
sunkų	s U N k uu
suomiją	s Uo m' i j' ea
supanti	s U p a n' t' i
supančių	s U p a n' tS' uu
suplaukdavo	s u p l A W g d a v oo
supurtė	s u p U r' t' ee
suranda	s u r A N d a
surasti	s u r A s' t' i
surengę	s u r' E N' g' ea
surinkimo	s u r' i n' k' I m oo
surinktos	s u r' i n k t oo s
susidariusiame	s u s' i d aA r' u s' e m' e
susidariusių	s u s' i d aA r' u s' uu
susidarė	s u s' i d aA r' ee
susidarę	s u s' i d aA r' ea
susidaręs	s u s' i d aA r' ea s
susideda	s u s' I d' e d a
susidomėjimo	s u s' i d oo m' Ee j' i m oo
susiejusių	s u s' Ie j' u s' uu
susietos	s u s' ie t oo s
susiformavo	s u s' i f o r m aA v oo
susiformavęs	s u s' i f o r m aA v' ea s
susijungę	s u s' i j' U n' g' ea
susijusių	s u s' I j' u s' uu
susikerta	s u s' I k' e r t a
susirinkimas	s u s' i r' i n' k' I m a s
suskaičiuojama	s u s k a j tS' Uo j' e m a
susprogdintos	s u s p r oo g' d' I n t oo s
sustatyti	s u s t a t' Ii t' i
sustingę	s u s' t' I n' g' ea
sustiprinti	s u s' t' I p' r' i n' t' i
sustojimu	s u s t oo j' i m U
sutampa	s u t A M p a
sutartines	s u t a r' t' i n' E s
sutartinių	s u t a r' t' I n' uu
sutartinės	s u t a r' t' I n' ee s
sutartinėse	s u t a r' t' I n' ee s' e
sutartinę	s u t a r' t' I n' ea
sutartyje	s u t a r' t' ii j' E
suteiktas	s U t' e j k t a s
suteikė	s U t' e j k' ee
suteka	s U t' e k a
sutemus	s u t' eA m u s
sutemų	s u t' e m uU
sutrukdė	s u t r U g' d' ee
suvalkijos	s u v a l' k' I j' oo s
sučiupti	s u tS' U p' t' i
suėsti	s u Ee s' t' i
sužeisti	s u Z' E J s' t' i
svaigina	s v a j g' I n a
svaigino	s v a j g' I n oo
svarbiausi	s v a r' b' Ea w s' i
svarbiausios	s v a r' b' Ea w s' oo s
svarbiausius	s v a r' b' Ea w s' u s
svarbiausių	s v a r' b' Ea w s' uu
svarbią	s v A R' b' ea
svarbių	s v a r' b' uU
svarbus	s v a r b U s
sveiki	s' v' e j k' I
sveria	s' v' eA r' e
sveriantys	s' v' eA r' e n' t' ii s
sveriančio	s' v' eA r' e n' tS' oo
sveriančių	s' v' eA r' e n' tS' uu
sviedęs	s' v' Ie d' ea s
svorio	s v oO r' oo
svoris	s v oO r' i s
svyravimai	s' v' ii r aA v' i m a j
svyruoja	s' v' ii r Uo j' e
sąlygas	s Aa l' ii g a s
sąlygų	s Aa l' ii g uu
sąrašą	s Aa r a S aa
sėjos	s' ee j' oO s
sėslus	s' ee s l U s
sūnus	s uu n U s
sūnūs	s Uu n uu s
t	t' ee
ta	t A
tad	t a t
tada	t a d A
tai	t a j
taigi	t A J g' i
taigoje	t a j g oo j' E
taikiai	t A J k' e j
taikingo	t a j k' I n g oo
taip	t A J p
tais	t A J s
taisyklinga	t a j s' ii k' l' I n g a
takai	t a k A J
taksi	t a k' s' I
tam	t Aa m
tams	t A M s
tamsai	t A M s a j
tamsoje	t a m s oo j' E
tankiu	t a n' k' u
tapo	t aA p oo
taps	t A p s
tapti	t A p' t' i
tapus	t aA p u s
tapusios	t aA p u s' oo s
tapusį	t aA p u s' ii
tapybos	t a p' Ii b oo s
tarmių	t a r' m' uU
tarmės	t a r' m' ee s
tarnavo	t a r n aA v oo
tarp	t a r p
tarpeklius	t a r' p' e k' l' U s
tarpeklyje	t a r' p' eA k' l' ii j' e
tarpu	t Aa r p u
tarpupirščiuose	t a r p U p' i r' S' tS' uo s' e
tarpusavio	t a r p U s a v' oo
tarpusavyje	t a r p U s a v' ii j' e
tarsi	t A R' s' i
tarytum	t a r' Ii t u m
tas	t A s
tau	t Aa w
tauta	t a w t A
tautos	t a w t oO s
tautybei	t a w t' Ii b' e j
tautybę	t a w t' Ii b' ea
tautų	t a w t uU
tačiau	t a tS' e w
taškų	t a S k uU
te	t' E
tebeveikiančiais	t' e b' e v' E J k' e n' tS' e j s
tebėra	t' e b' ee r A
techniką	t' E x' n' i k aa
technologijas	t' e x n o l O g' i j' e s
teigia	t' E J g' e
teigiama	t' e j g' e m a
teises	t' Ea j s' e s
teisių	t' e j s' uu
teka	t' eA k a
tekstas	t' E k s t a s
tekstuose	t' E k s t uo s' e
televizorių	t' e l' e v' I z o r' uu
telkiniai	t' e l' k' i n' E J
telkiniuose	t' e l' k' i n' uo s' E
telkinių	t' e l' k' i n' uU
telkinys	t' e l' k' i n' iI s
temperatūros	t' e m' p' e r a t uU r oo s
temperatūrą	t' e m' p' e r a t uU r aa
temperatūrų	t' e m' p' e r a t uU r uu
tempiant	t' E M' p' e n t
tempo	t' E M p oo
tempti	t' E M' p' t' i
temti	t' Ea m' t' i
ten	t' E N
teorijos	t' e O r' i j' oo s
teorijų	t' e O r' i j' uu
terakotiniai	t' e r a k oo t' i n' e j
terakotinė	t' e r a k oo t' i n' ee
terakotinės	t' e r a k oo t' i n' ee s
terakotinę	t' e r a k oo t' i n' ea
terasoje	t' e r aA s oo j' e
terasomis	t' e r aA s oo m' i s
terasų	t' e r aA s uu
teritorija	t' e r' i t O r' i j' e
teritorijai	t' e r' i t O r' i j' e j
teritorijoje	t' e r' i t O r' i j' oo j' e
teritorijos	t' e r' i t O r' i j' oo s
teritorijose	t' e r' i t O r' i j' oo s' e
teritoriją	t' e r' i t O r' i j' ea
termosus	t' Ea r m o s u s
tie	t' iE
tiek	t' Ie k
tiekti	t' iE k' t' i
ties	t' ie s
tiesia	t' iE s' e
tiesiog	t' ie s' Oo k
tiesioginio	t' ie s' Oo g' i n' oo
tiesos	t' ie s oO s
tiesų	t' ie s uU
tigrais	t' I g r a j s
tik	t' i k
tikima	t' I k' i m a
tikram	t' i k r Aa m
tikrasis	t' i k r A s' i s
tikriausiai	t' i k' r' Ea w s' e j
tikrųjų	t' i k r uU j' uu
tikslas	t' I k s l a s
tiksliai	t' i k' s' l' E J
tiksliam	t' i k' s' l' Ea m
tiksliau	t' i k' s' l' E W
tiksliausiai	t' i k' s' l' Ea w s' e j
tikslo	t' I k s l oo
tiktai	t' i k t a j
tikėjimo	t' i k' Ee j' i m oo
tikėjimą	t' i k' Ee j' i m aa
tikėtina	t' i k' Ee t' i n a
tikėtinai	t' i k' Ee t' i n a j
tinkamas	t' I N k a m a s
tinklas	t' I N k l a s
tinklo	t' I N k l oo
tinklu	t' i n k l U
tinku	t' i n k u
tinkuotos	t' i n k Uo t oo s
tiria	t' I r' e
tirpimą	t' i r' p' I m aa
tirps	t' I R p s
tirti	t' I r' t' i
to	t oO
todėl	t oo d' eE l
toje	t oo j' E
toji	t Oo j' i
tokia	t oo k' E
tokiame	t oo k' e m' E
tokias	t Oo k' e s
tokie	t oo k' iE
tokio	t Oo k' oo
tokios	t oo k' oo s
tokiu	t Oo k' u
tokiuose	t oo k' uo s' E
tokią	t Oo k' ea
tokių	t oo k' uU
toks	t Oo k s
tokį	t Oo k' ii
tolesnę	t oo l' E s' n' ea
toliau	t oo l' E W
tolimų	t oo l' i m uU
toly	t O l' ii
tolyn	t oo l' iI n
tonas	t O n a s
tono	t O n oo
tonos	t O n oo s
tonu	t o n U
tonų	t O n uu
topografijos	t o p o g r aA f' i j' oo s
tos	t oO s
tradicija	t r a d' I ts' i j' e
tradicijoje	t r a d' I ts' i j' oo j' e
tradicijos	t r a d' I ts' i j' oo s
tradicinių	t r a d' I ts' i n' uu
trakai	t r aA k a j
traktuoti	t r a k t Uo t' i
trakus	t r a k U s
trakų	t r a k uu
traukiasi	t r Aa w k' e s' i
traukė	t r Aa w k' ee
trejinę	t' r' eA j' i n' ea
trejų	t' r' e j' uU
trečiajam	t' r' e tS' Ea j' e m
trečiasis	t' r' e tS' E s' i s
trianguliacijos	t' r' e n g u l' eA ts' i j' oo s
trigubus	t' r' I g u b u s
trijose	t' r' i j' oo s' E
trijų	t' r' i j' uU
trikdomi	t' r' I g d oo m' i
trilijonų	t' r' i l' i j' oO n uu
tris	t' r' I s
trisdešimt	t' r' I z' d' e S' i m t
trisdešimties	t' r' I z' d' e S' i m' t' ie s
trise	t' r' i s' E
triukšmas	t' r' U k S m a s
triūsą	t' r' uU s aa
trobelėse	t r oo b' eA l' ee s' e
trukdavo	t r U g d a v oo
trukdo	t r U g d oo
truko	t r U k oo
trukti	t r U k' t' i
trumpais	t r u m p A J s
trumpesnė	t r u m' p' E s' n' ee
trumputės	t r u m p U t' ee s
trumpų	t r u m p uU
tryliktame	t' r' Ii l' i k t a m' e
trys	t' r' iI s
trūko	t r Uu k oo
trūkstant	t r Uu k s t a n t
tuko	t U k oo
tundroje	t U n d r oo j' e
tundros	t U n d r oo s
tuo	t uO
tuomet	t uo m' E t
tuometinės	t uo m' e t' I n' ee s
tupėdamas	t u p' Ee d a m a s
turgaus	t U R g a w s
turgus	t U R g u s
turi	t U r' i
turinio	t U r' i n' oo
turistai	t u r' I s t a j
turistas	t u r' I s t a s
turistui	t u r' I s t u j
turistus	t u r' i s t U s
turistų	t u r' I s t uu
turiu	t u r' U
turizmas	t u r' I z m a s
turėdami	t u r' Ee d a m' i
turėjo	t u r' Ee j' oo
turėjęs	t u r' Ee j' ea s
tus	t U s
tvarkingai	t v a r' k' I n g a j
tvirtina	t' v' I r' t' i n a
tvirtove	t' v' i r t Oo v' e
tvirtų	t' v' i r t uU
tyli	t' iI l' i
tyrimai	t' ii r' I m a j
tyrimais	t' ii r' I m a j s
tyrimo	t' ii r' I m oo
tyrinėjimai	t' ii r' i n' Ee j' i m a j
tyrėju	t' ii r' Ee j' u
tyrėjų	t' ii r' Ee j' uu
tėra	t' ee r A
tėvas	t' Ee v a s
tėvo	t' Ee v oo
tėčiu	t' ee tS' U
tęsiamas	t' eA s' e m a s
tęsiasi	t' eA s' e s' i
tęstinumą	t' ea s' t' i n U m aa
tęsėsi	t' eA s' ee s' i
tūkstantaisiais	t Uu k s t a n t a j s' e j s
tūkstanti	t Uu k s t a n' t' i
tūkstantis	t Uu k s t a n' t' i s
tūkstantmetyje	t Uu k s t a n' t' m' e t' ii j' e
tūkstantį	t Uu k s t a n' t' ii
tūkstančiai	t Uu k s t a n' tS' e j
tūkstančio	t Uu k s t a n' tS' oo
tūkstančius	t Uu k s t a n' tS' u s
tūkstančių	t Uu k s t a n' tS' uu
tų	t uU
ugnies	u g' n' iE s
ugnikalniu	u g' n' I k a l' n' u
ugnikalnių	u g' n' I k a l' n' uu
ugnis	u g' n' I s
ukrainą	u k r a I n aa
undinės	u n' d' I n' ee s
ungurius	U N g u r' u s
uniformos	u n' i f O r m oo s
unikaliai	u n' i k a l' E J
unikalių	u n' i k a l' uU
unikalus	u n' i k a l U s
universiteto	u n' i v' e r' s' i t' E t oo
uodega	uo d' e g A
uodegą	Uo d' e g aa
uogų	Uo g uu
uola	uo l A
uolienas	uo l' Ie n a s
uolienoms	uo l' Ie n oo m s
uolos	uo l oO s
uolu	uo l U
uolą	uO l aa
uolų	uo l uU
uoslę	uO s' l' ea
up	u p
upelius	u p' e l' U s
upelių	u p' eA l' uu
upes	u p' E s
upinius	U p' i n' u s
upiu	u p' u
upių	U p' uu
upė	U p' ee
upės	U p' ee s
urvai	u r v A J
urvas	U r v a s
urvo	U r v oo
urvus	U r v u s
urvą	U r v aa
urvų	u r v uU
urzgimas	u r' z' g' I m a s
usūriniai	u s uU r' i n' e j
utenoje	u t' e n oo j' E
už	u S
užbaigimo	u Z b a j g' I m oo
užburiančiais	U Z b u r' e n' tS' e j s
uždaros	u Z d a r oo s
uždarytas	u Z d a r' Ii t a s
užfiksuota	u Z' f' i k s Uo t a
užgožė	U Z g oo Z' ee
užgrobtas	u Z g r Oo p t a s
užima	U Z' i m a
užimamas	U Z' i m a m a s
užkopti	u S k oo p' t' i
užlieja	u Z' l' Ie j' e
užnemunės	U Z' n' e m u n' ee s
užnešti	u Z' n' E S' t' i
užpakalinėmis	u S p a k a l' I n' ee m' i s
užpiltas	u S' p' I l t a s
užpuola	u S p Uo l a
užrašus	U Z r a S u s
užrašyti	u Z r a S' Ii t' i
užregistruoti	u Z' r' e g' i s t r Uo t' i
užsidaro	u S' s' i d aA r oo
užsienio	U S' s' ie n' oo
užsilipa	u S' s' I l' i p a
užsirūstina	u S' s' i r Uu s' t' i n a
užsitęsusios	u S' s' i t' eA s u s' oo s
užtempiami	u S' t' e m' p' e m' I
užtempti	u S' t' E M' p' t' i
užtemti	u S' t' Ea m' t' i
užtikrina	u S' t' I k' r' i n a
užtikrino	u S' t' I k' r' i n oo
užtvanka	U S t v a n k a
užtvankas	U S t v a n k a s
užtvankos	U S t v a n k oo s
užtvarą	U S t v a r aa
užtvindydami	u S' t' v' I n' d' ii d a m' i
užtvindė	u S' t' v' I n' d' ee
užuominų	u Z Uo m' i n uu
užėmė	U Z' ee m' ee
užšifruotą	u S' S' i f r Uo t aa
vabzdžius	v a b' Z' dZ' U s
vabzdžių	v a b' Z' dZ' uU
vadina	v a d' I n a
vadinama	v a d' I n a m a
vadinamas	v a d' I n a m a s
vadinami	v a d' I n a m' i
vadinasi	v a d' I n a s' i
vadovų	v a d oO v uu
vadų	v a d uU
vagas	v a g A s
vaidmens	v a j d' m' E N s
vaikas	v A J k a s
vaikų	v a j k uU
vairavimas	v a j r aA v' i m a s
vaistus	v Aa j s t u s
vaizdai	v a j z d A J
vaizdais	v a j z d A J s
vaizdavo	v a j z d aA v oo
vaizdingomis	v a j z' d' I n g oo m' i s
vaizdini	v A J z' d' i n' i
vaizdinį	v a j z' d' i n' ii
vaizdo	v A J z d oo
vakare	v a k a r' E
vakarinėje	v a k a r' I n' ee j' e
vakarinės	v a k a r' I n' ee s
vakarų	v a k a r uU
valandas	v aA l a n d a s
valandą	v aA l a n d aa
valdas	v Aa l d a s
valdininkai	v a l' d' i n' I N k a j
valdo	v a l d oo
valdoma	v A L d oo m a
valdomas	v A L d oo m a s
valdovas	v a l d oO v a s
valdyme	v A L' d' ii m' e
valdymo	v A L' d' ii m oo
valdymui	v A L' d' ii m u j
valdė	v A L' d' ee
valdžią	v A L' dZ' ea
valgomieji	v Aa l g oo m' ie j' i
valgykla	v a l' g' ii k l A
valiutos	v a l' U t oo s
valkataujantys	v a l k a t Aa w j' e n' t' ii s
valstijos	v a l' s' t' I j' oo s
valstijose	v a l' s' t' I j' oo s' e
valstybes	v a l' s' t' Ii b' e s
valstybinę	v a l' s' t' Ii b' i n' ea
valstybių	v a l' s' t' Ii b' uu
valstybėmis	v a l' s' t' Ii b' ee m' i s
valstybėms	v a l' s' t' Ii b' ee m s
valstybės	v a l' s' t' Ii b' ee s
vandeningas	v a n' d' e n' I n g a s
vandeningesnės	v a n' d' e n' i n' g' e s' n' ee s
vandeningumas	v a n' d' e n' i n g U m a s
vandeniniais	v a n' d' e n' I n' e j s
vandeniu	v Aa n' d' e n' u
vandeniui	v Aa n' d' e n' u j
vandens	v a n' d' E N s
vandeny	v a n' d' e n' iI
vandenyje	v a n' d' e n' ii j' E
vandenynas	v a n' d' e n' Ii n a s
vandenyno	v a n' d' e n' Ii n oo
vandenį	v Aa n' d' e n' ii
vandenų	v a n' d' e n uU
vanduo	v a n d uO
varda	v a r d a
vardai	v a r d A J
vardas	v A R d a s
vardą	v A R d aa
variantas	v a r' i Aa n t a s
varles	v a r' l' e s
vartais	v a r t a j s
vartojamų	v a r t Oo j' e m uu
vasaros	v aA s a r oo s
vatikano	v a t' i k aA n oo
veikia	v' E J k' e
veikiančių	v' E J k' e n' tS' uu
veiklai	v' E J k l a j
veikli	v' e j k' l' I
veiklos	v' e j k l oO s
veiklūs	v' E J k l uu s
veiksmas	v' E J k s m a s
veikti	v' E J k' t' i
veisiasi	v' E J s' e s' i
veistis	v' E J s' t' i s
veliau	v' e l' e w
veltui	v' Ea l t u j
velėna	v' e l' Ee n a
vengia	v' Ea n' g' e
vergai	v' e r g A J
vergų	v' e r g uU
verpstiškas	v' E R' p' s' t' i S k a s
versija	v' E r' s' i j' e
verslų	v' E R s l uu
vertingiausiu	v' e r' t' i n' g' Ea w s' u
vertėtų	v' e r' t' ee t uu
verčiamasi	v' E R' tS' e m a s' i
veržėsi	v' E R' Z' ee s' i
vešlios	v' e S' l' oo s
vežimai	v' e Z' I m a j
vežimų	v' e Z' I m uu
vidaus	v' i d A W s
vidinis	v' i d' I n' i s
viduje	v' i d u j' E
viduramžių	v' i d U r a m' Z' uu
vidurdienio	v' i d U r' d' ie n' oo
vidurinių	v' i d u r' I n' uu
vidurinė	v' i d u r' I n' ee
vidurio	v' I d u r' oo
viduriu	v' I d u r' u
viduryje	v' i d u r' ii j' E
viduržemio	v' i d U r' Z' e m' oo
vidutinis	v' i d u t' I n' i s
vidutiniškai	v' i d u t' I n' i S k a j
vien	v' Ie n
viena	v' ie n A
vienai	v' Ie n a j
vienam	v' ie n Aa m
viename	v' ie n a m' E
vienas	v' Ie n a s
vienbalsiškumas	v' ie n b a l' s' i S k U m a s
vienetas	v' Ie n' e t a s
vienetines	v' ie n' e t' i n' E s
vienetinėms	v' ie n' e t' I n' ee m s
vieni	v' ie n' I
vieningą	v' ie n' I n g aa
vienintelis	v' ie n' I N' t' e l' i s
vieninteliu	v' ie n' I N' t' e l' u
vieno	v' Ie n oo
vienodais	v' ie n Oo d a j s
vienodo	v' ie n Oo d oo
vienoje	v' ie n oo j' E
vienos	v' ie n oO s
viens	v' Ie n s
vientisesnis	v' ie n' t' i s' E s' n' i s
vienu	v' Ie n u
vienuoliai	v' ie n uO l' e j
vienuolika	v' ie n Uo l' i k a
vienuolikos	v' ie n Uo l' i k oo s
vienuoliktais	v' ie n Uo l' i k t a j s
vienuoliu	v' ie n uo l' U
vienuolių	v' ie n uO l' uu
vienuolynai	v' ie n uo l' Ii n a j
vienuolynais	v' ie n uo l' Ii n a j s
vienuolynas	v' ie n uo l' Ii n a s
vienuolyne	v' ie n uo l' Ii n' e
vienuolyno	v' ie n uo l' Ii n oo
vienuolynu	v' ie n uo l' Ii n u
vienuolynus	v' ie n uo l' Ii n u s
vienuolyną	v' ie n uo l' Ii n aa
vienuolynų	v' ie n uo l' Ii n uu
vieną	v' Ie n aa
vieta	v' ie t A
vietas	v' ie t A s
vietinei	v' iE t' i n' e j
vietines	v' iE t' i n' e s
vietiniai	v' iE t' i n' e j
vietiniams	v' iE t' i n' e m s
vietinių	v' iE t' i n' uu
vietinėms	v' iE t' i n' ee m s
vietoje	v' iE t oo j' e
vietomis	v' iE t oo m' i s
vietos	v' iE t oo s
vietose	v' iE t oo s' e
vietovė	v' ie t Oo v' ee
vietovėje	v' ie t Oo v' ee j' e
vietovėmis	v' ie t Oo v' ee m' i s
vietovės	v' ie t Oo v' ee s
vietovėse	v' ie t Oo v' ee s' e
vietovę	v' ie t Oo v' ea
vietą	v' iE t aa
vietų	v' iE t uu
viešpatauja	v' ie S p a t Aa w j' e
viktorijos	v' i k t O r' i j' oo s
vilkai	v' i l k a j
vilkams	v' i l k Aa m s
vilkas	v' I L k a s
vilko	v' I L k oo
vilkui	v' I L k u j
vilkus	v' i l k U s
vilkų	v' i l k uu
vilniaus	v' I l' n' e w s
vilniui	v' I l' n' u j
vilniuje	v' I l' n' u j' e
vilnius	v' I l' n' u s
vilnių	v' I l' n' uu
vingiuoja	v' i n' g' Uo j' e
vingiuojantis	v' i n' g' Uo j' e n' t' i s
vingiuota	v' i n' g' Uo t a
vinguriuojantis	v' i n g u r' Uo j' e n' t' i s
virtinę	v' i r' t' i n' ea
virtuvę	v' i r t U v' ea
virš	v' i r S
viršaus	v' i r S A W s
viršuje	v' i r S u j' E
viršumi	v' i r S u m' I
viršutiniai	v' i r S u t' I n' e j
viršutinėje	v' i r S u t' I n' ee j' e
viršutinės	v' i r S u t' I n' ee s
viršutinę	v' i r S u t' I n' ea
viršutinį	v' i r S u t' I n' ii
viršūne	v' i r S Uu n' e
viršūnė	v' i r S Uu n' ee
viršūnėje	v' i r S Uu n' ee j' e
viršūnėmis	v' i r S Uu n' ee m' i s
viršūnės	v' i r S Uu n' ee s
viršūnę	v' i r S Uu n' ea
vis	v' I s
visada	v' i s a d A
visai	v' i s Aa j
visas	v' i s a s
visi	v' i s' I
visiškai	v' I s' i S k a j
viskas	v' I s k a s
viskuo	v' I s k uo
viso	v' I s oo
visoje	v' i s oo j' E
visos	v' i s oo s
visose	v' i s oo s' E
visu	v' i s U
visur	v' i s U R
visus	v' i s U s
visą	v' I s aa
visų	v' i s uU
vizoje	v' I z oo j' e
vokalo	v o k aA l oo
vokiečiai	v Oo k' ie tS' e j
vokiečiais	v Oo k' ie tS' e j s
vokiečių	v Oo k' ie tS' uu
voras	v Oo r a s
vos	v oO s
vulkaninės	v u l k aA n' i n' ee s
vykdavo	v' iI g d a v oo
vykdomojo	v' Ii g d oo m oo j' oo
vyno	v' iI n oo
vyras	v' Ii r a s
vyravo	v' Ii r a v oo
vyro	v' Ii r oo
vyru	v' Ii r u
vyrų	v' Ii r uu
vystymuisi	v' Ii s' t' ii m u j s' i
vystėsi	v' Ii s' t' ee s' i
vytautas	v' Ii t a w t a s
vėjai	v' Ee j' e j
vėjams	v' Ee j' e m s
vėjas	v' Ee j' e s
vėjų	v' Ee j' uu
vėliau	v' ee l' E W
vėžius	v' Ee Z' u s
vėžlių	v' ee Z' l' uU
y	ii i l g Oo j' i
ypatingas	ii p a t' I n g a s
ypač	Ii p a tS
yra	ii r A
zanavykų	z a n a v' iI k uu
zelandijoje	z' e l Aa n' d' i j' oo j' e
zelandijos	z' e l Aa n' d' i j' oo s
zonoj	z O n oo j
zonoje	z O n oo j' e
zonose	z O n oo s' e
Čilėe	tS' i l' ee e
Čilėje	tS' I l' ee j' e
Čilės	tS' I l' ee s
čaižant	tS Aa j Z a n t
čia	tS' E
Ėstijos	ee s' t' i j' oo s
Ėstiją	ee s' t' i j' ea
ėda	Ee d a
ėmus	eE m u s
ėmė	eE m' ee
į	iI
įdomiausia	ii d oo m' Ea w s' e
įdomu	ii d oo m U
įdubos	Ii d u b oo s
įdubų	Ii d u b uu
įeina	ii E J n a
įeiti	ii E J t' i
įgaubtais	ii g a w p t A J s
įgyvendinami	ii g' ii v' Ea n' d' i n a m' i
įkopė	ii k oo p' ee
įkurtas	ii k U r t a s
įkurti	ii k U r' t' i
įkūrimo	ii k uu r' I m oo
įkūrė	ii k Uu r' ee
įkūrę	ii k Uu r' ea
įminti	ii m' i n' t' i
įprasta	ii p r a s t a
įrašyta	ii r a S' Ii t a
įrašytas	ii r a S' Ii t a s
įrengia	ii r' E N' g' e
įrengimas	ii r' e n' g' I m a s
įrenginio	Ii r' e n' g' i n' oo
įrenginių	ii r' e n' g' i n' uU
įrengta	ii r' e n k t a
įrengti	ii r' E N' k' t' i
įrodė	ii r Oo d' ee
įsakė	ii s aA k' ee
įsigaliojus	ii s' i g a l' Oo j' u s
įsijungia	ii s' i j' U n' g' e
įsikūrė	ii s' i k Uu r' ee
įsikūrę	ii s' i k Uu r' ea
įsiruošia	ii s' i r uO S' e
įsiterpus	ii s' i t' E R p u s
įsitikina	ii s' i t' I k' i n a
įsiutęs	ii s' U t' ea s
įsiūbuoti	ii s' uu b Uo t' i
įskaičiavus	ii s k a j tS' eA v u s
įsodintą	ii s oo d' I n t aa
įspūdi	ii s p uU d' i
įspūdingiausias	ii s p uu d' i n' g' Ea w s' e s
įspūdingiausių	ii s p uu d' i n' g' Ea w s' uu
įspūdingo	ii s p uu d' I n g oo
įspūdingus	ii s p uu d' I n g u s
įspūdingą	ii s p uu d' I n g aa
įspūdį	Ii s p uu d' ii
įstatymas	ii s t aA t' ii m a s
įstatymui	ii s t aA t' ii m u j
įsteigė	iI s' t' e j g' ee
įtaisytais	ii t a j s' Ii t a j s
įtakos	Ii t a k oo s
įtaką	Ii t a k aa
įteka	iI t' e k a
įtrūkimu	ii t r uu k' i m U
įtrūkių	Ii t r uu k' uu
įtvirtinimai	ii t' v' I r' t' i n' i m a j
įtvirtinta	ii t' v' I r' t' i n t a
įtvirtintas	ii t' v' I r' t' i n t a s
įtvirtintos	ii t' v' I r' t' i n t oo s
įvairi	ii v a j r' I
įvairiais	ii v a j r' E J s
įvairiausios	ii v a j r' Ea w s' oo s
įvairios	ii v a j r' oo s
įvairiose	ii v a j r' oo s' E
įvairiuose	ii v a j r' uo s' E
įvairių	ii v a j r' uU
įvairūs	ii v A J r uu s
įvarydama	ii v a r' Ii d a m a
įveikti	ii v' E J k' t' i
įvesta	ii v' e s t a
įėjimo	ii ee j' I m oo
įžengdavo	ii Z' E N g d a v oo
įžengiama	ii Z' e n' g' e m a
įžengiame	ii Z' E N' g' e m' e
įžengti	ii Z' E N' k' t' i
Šamano	S a m aA n oo
Šiaurės	S' Ea w r' ee s
Širvintų	S' i r' v' i n t uU
Škotija	S k O t' i j' e
Škotijoje	S k O t' i j' oo j' e
Švedijoj	S' v' E d' i j' oo j
Švedijoje	S' v' E d' i j' oo j' e
Švediją	S' v' E d' i j' ea
šachtų	S aA x t uu
šaka	S a k A
šaknimis	S a k' n' i m' I s
šaknų	S a k n uU
šakomis	S a k oo m' I s
šakos	S a k oO s
šakų	S a k uU
šaldyto	S Aa l' d' ii t oo
šaldytuvu	S a l' d' ii t u v U
šalia	S a l' E
šalies	S a l' iE s
šalimi	S a l' i m' I
šalinant	S aA l' i n a n t
šalinimą	S aA l' i n' i m aa
šalių	S a l' uU
šalta	S a l t a
šaltiniai	S a l' t' I n' e j
šaltiniuose	S a l' t' I n' uo s' e
šaltyje	S A L' t' ii j' e
šalyse	S a l' ii s' E
šalčiausio	S a l' tS' Ea w s' oo
šamanų	S a m aA n uu
šarvai	S a r v A J
šeimomis	S' e j m oo m' I s
šeimos	S' e j m oO s
šeimyninę	S' e j m' Ii n' i n' ea
šeimų	S' e j m uU
šermuonėliai	S' e r m uo n' eE l' e j
šermuonėlis	S' e r m uo n' eE l' i s
šermuonėliui	S' e r m uo n' eE l' u j
šešerius	S' eA S' e r' u s
šeši	S' e S' I
šešiasdešimt	S' eA S' e z' d' e S' i m t
šešiasdešimties	S' eA S' e z' d' e S' i m' t' ie s
šešiasdešimtuosius	S' e S' e z' d' e S' i m t Uo s' u s
šešiasdešimtų	S' e S' e z' d' e S' i m t uU
šešiolika	S' e S' Oo l' i k a
šešiolikos	S' e S' Oo l' i k oo s
šešioliktame	S' e S' Oo l' i k t a m' e
šešiolikto	S' e S' Oo l' i k t oo
šešios	S' eA S' oo s
šešis	S' e S' I s
šešių	S' e S' uU
šeštais	S' e S t A J s
šešto	S' eA S t oo
ši	S' I
šia	S' E
šiam	S' Ea m
šiandien	S' E N' d' ie n
šias	S' E s
šiaurinės	S' e w r' I n' ee s
šiaurė	S' Ea w r' ee
šiaurėje	S' Ea w r' ee j' e
šiaurės	S' Ea w r' ee s
šie	S' iE
šiek	S' ie k
šilta	S' i l t a
šiltų	S' i l t uU
šilumos	S' i l u m oO s
šimtai	S' i m t A J
šimtais	S' i m t A J s
šimtas	S' I M t a s
šimtmečiais	S' I M' t' m' e tS' e j s
šimtmečius	S' I M' t' m' e tS' u s
šimto	S' I M t oo
šimtu	S' i m t U
šimtus	S' i m t U s
šimtą	S' I M t aa
šimtų	S' i m t uU
šio	S' oO
šioje	S' oo j' E
šiol	S' oO l
šios	S' oO s
šis	S' I s
šiuo	S' uO
šiuolaikinė	S' uo l a j k' I n' ee
šiuolaikinės	S' uo l a j k' I n' ee s
šiuolaikinę	S' uo l a j k' I n' ea
šiuos	S' uO s
šią	S' eA
šių	S' uU
šlaite	S l a j t' E
šlaituose	S l A J t uo s' e
šlaitus	S l a j t U s
šlaitą	S l A J t aa
šmėstelėjusią	S' m' Ee s' t' e l' ee j' u s' ea
šnektų	S' n' e k t uU
šnervės	S' n' Ea r' v' ee s
šniokštimas	S' n' oo k' S' t' I m a s
šonais	S Oo n a j s
šovė	S Oo v' ee
štai	S t A J
šuninių	S u n' I n' uu
šunys	S U n' ii s
šunų	S u n uU
švelnesnės	S' v' e l' n' e s' n' ee s
švelnius	S' v' e l' n' U s
švelnumas	S' v' e l n U m a s
šventasis	S' v' e n t A s' i s
šventes	S' v' e n' t' E s
šventikai	S' v' e n' t' I k a j
šventojo	S' v' E N t oo j' oo
šventosios	S' v' e n t oo s' oo s
šventu	S' v' e n t U
šventykla	S' v' e n' t' ii k l A
šventyklos	S' v' e n' t' iI k l oo s
šventyklą	S' v' e n' t' iI k l aa
šventyklų	S' v' e n' t' iI k l uu
šventąją	S' v' E N t aa j' ea
švenčiausia	S' v' e n' tS' Ea w s' e
švenčių	S' v' E N' tS' uu
švyturių	S' v' ii t u r' uU
šydas	S' iI d a s
šį	S' iI
ūdra	Uu d r a
ūdrai	Uu d r a j
ūdros	Uu d r oo s
ūdrų	Uu d r uu
ūkininkai	Uu k' i n' i n k a j
ūkio	Uu k' oo
ūkiu	Uu k' u
ūktelėjama	Uu k' t' e l' ee j' e m a
ūktelėjimas	Uu k' t' e l' ee j' i m a s
ūktelėjimu	Uu k' t' e l' ee j' i m u
ūktelėjimą	Uu k' t' e l' ee j' i m aa
ūktelėti	Uu k' t' e l' ee t' i
Žemaitijai	Z' e m a j t' I j' e j
Žemaitijos	Z' e m a j t' I j' oo s
Žemės	Z' eA m' ee s
žaisti	Z A J s' t' i
žemaičiai	Z' e m A J tS' e j
žemaičių	Z' e m A J tS' uu
žemdirbio	Z' Ea m' d' i r' b' oo
žemdirbyste	Z' e m' d' i r' b' ii s' t' E
žeme	Z' e m' E
žemiau	Z' e m' E W
žemiškesnių	Z' e m' i S' k' e s' n' uU
žemumose	Z' e m u m oo s' E
žemutinė	Z' e m u t' I n' ee
žemutinį	Z' e m u t' I n' ii
žemyn	Z' e m' iI n
žemė	Z' eA m' ee
žemėlapyje	Z' e m' Ee l a p' ii j' e
žemės	Z' eA m' ee s
žemę	Z' eA m' ea
žengti	Z' E N' k' t' i
ženklai	Z' e n k l A J
ženklas	Z' Ea n k l a s
ženklą	Z' Ea n k l aa
žiemai	Z' iE m a j
žiemos	Z' ie m oO s
žiemą	Z' iE m aa
žiemų	Z' ie m uU
žieve	Z' ie v' E
žievę	Z' iE v' ea
žinduolio	Z' i n d uO l' oo
žinduolis	Z' i n d uO l' i s
žinduoliu	Z' i n d uo l' U
žinduolių	Z' i n d uO l' uu
žingsnis	Z' I N' k' s' n' i s
žinia	Z' i n' E
žinią	Z' I n' ea
žinių	Z' i n' uU
žinoma	Z' i n oo m a
žinomas	Z' i n oo m a s
žinomiausi	Z' i n oo m' Ea w s' i
žinomiausia	Z' i n oo m' Ea w s' e
žinomiausias	Z' i n oo m' Ea w s' e s
žinomo	Z' i n oo m oo
žinomą	Z' i n oo m aa
žiogus	Z' Oo g u s
žiurkes	Z' U r' k' e s
žiurkėmis	Z' U r' k' ee m' i s
žiurkės	Z' U r' k' ee s
žiūrėti	Z' uu r' Ee t' i
žlugimo	Z l u g' I m oo
žmogaus	Z m oo g A W s
žmogų	Z m oO g uu
žmona	Z m oo n A
žmonijos	Z m oo n' I j' oo s
žmonių	Z m oo n' uU
žmonėms	Z m oo n' Ee m s
žmonės	Z m Oo n' ee s
žodis	Z oO d' i s
žodžiais	Z oO dZ' e j s
žodžius	Z oo dZ' U s
žodžių	Z oO dZ' uu
žoliniais	Z oo l' I n' e j s
žolių	Z oo l' uU
žolėmis	Z oo l' ee m' I s
žolę	Z oO l' ea
žurnale	Z u r n a l' E
žuvies	Z u v' iE s
žuvingos	Z u v' I n g oo s
žuvis	Z u v' I s
žuvo	Z U v oo
žuvį	Z U v' ii
žuvų	Z u v uU
žvaigždynų	Z v a j g' Z' d' Ii n uu
žvaigždėlapį	Z v a j g' Z' d' Ee l a p' ii
žvaigždės	Z v a j g' Z' d' ee s
žvalgybinės	Z v a l' g' Ii b' i n' ee s
žvejyba	Z' v' e j' Ii b a
žvilgtelėjus	Z' v' I l' k' t' e l' ee j' u s
žvirgždo	Z' v' I R g Z d oo
žvyro	Z' v' iI r oo
žvėreliai	Z' v' ee r' eA l' e j
žvėrelis	Z' v' ee r' eA l' i s
žvėrelių	Z' v' ee r' eA l' uu
žvėrių	Z' v' ee r' uu
žymiai	Z' iI m' e j
žymiausių	Z' ii m' Ea w s' uu
žymus	Z' ii m U s
žymėjo	Z' ii m' Ee j' oo
žūva	Z uU v a
